BMG SELTEC==BMG SELTEC
CE_MAIN==מערכת מרכזית
CE_MIX==טכני
CE_PSRV==תקשורת
CE_LD==סדרן
CE_BATCH==מטעין
CE-DISPATCH==סדרן
CE - LOCAL DISPATCHER==סדרן
BVR_2_LIAD==התחברות לבקר
BVR_WGH_P==שקילה
OM_TBL_DEF==מחולל דוחות
CE_HSRV==תוכנית תקשורת מרכזית
CE APP SERVER HO==תוכנית תקשורת מרכזית
CE ERP - MAIN MENU==מערכת לניהול חברת בטון
MAIN MENU==תפריט הראשי
CE - MAIN MENU==מערכת לניהול חברת בטון
© BMG SELTEC ,  ALL RIGHTS RESERVED.==כל הזכויות שמורות .BMG SELTEC
© 2000  BMG SELTEC . ALL RIGHTS RESERVED.==כל הזכויות שמורות .Copyright © 2000 BMG SELTEC
© 2000 BMG SELTEC. ALL RIGHTS RESERVED.==כל הזכויות שמורות .Copyright © 2000 BMG SELTEC
OK==אישור
CANCEL==ביטול
Bt_Cancl==ביטול
REPORT MANAGEMENT==ניהול דוחות
NEW==חדש
ADD==הוספה
DELETE==מחיקה
DESIGN==תכנון
EXCEL==*
PRINT==הדפסה
DECISION CUBE==*
GROUP==קבוצה
DESCRIPTION ==תיאור
NAME ==שם
EXCEL FILE PATH ==הפנייה לקובץ אקסל
START ROW ==*
START COLUMN ==*
GROUP ==קבוצה
(EMPTY)==ריק
BRANCH==מפעל
COMPANY==חברה
OWNER==בעלים
ID==מספר
DESCRIPTION==תיאור
BATCH TERMINAL==מסוף
RELOAD==טען מחדש
&FILE==קובץ
TABLES==טבלאות
ITEM GROUPS==פריטים
ACCOUNTS==כרטיסי לקוח/ספק
WALKIN==לקוחות מזדמנים
SYSTEM TREE==מבנה המערכת
CONTRACTS==הסכמים
TARIFFS==מחירונים
TRANSPORT CONTRACTS==הסכמי הובלה
BASE INDEX==מדדים
COMPLEX INDEX==מדדים מורכבים
SUPP CONTRACTS==הסכמי ספקים
NEW RATES==מט"ח חדש
SET RATES==טבלת מט"ח
EXIT==יציאה
&TOOLS==כלים
BATCH==מסוף
SORT GROUP ENTRY==הגדרת קבוצות מיון
INI FILE==קובץ INI
CONTRACT INDEX==מדד ההסכם
TRANS CONTRACT INDEX==מדד הסכם הובלה
&ACCOUNTING==הנהלת חשבונות
INVOICES==חשבונית
RECEIPTS==קבלה
PERIOD INVOICES==חשבוניות תקופתיות
DEPOSITS==רישום הפקדה
CALC SHIP DOCK==חישוב תעודות משלוח
CHARGE ORDERS==הוראות קבע
ACCOUNTING DEFINITIONS==הגדרות להנהלת חשבונות
ACCOUNT TRANSACTIONS LINK==בניית פקודות יומן
BUILD SUPPLIER INVOICE==הקמת חשבונית ספק
INSTALLMENT==הסדר תשלומים
PLANT==מפעל
PLANT COMMUNICATION==תקשורת במפעל
DEFINE PRODUCTION PARAMS==הגדרות יצור
DAILY CLOSING==סגירת יום
&HEAD OFFICE OPERATIONS==מרכז
HEAD OFFICE OPERATIONS==מרכז
MANUAL SHIP DOCK ENTRY==תעודת משלוח ידנית
MANUAL STOCK ENTRY==כניסת מלאי ידנית
SHIP DOCK MODIF.==עדכון תעודות משלוח
&CRM COMPONENTS==ניהול קשרי לקוחות
CRM COMPONENTS==ניהול קשרי לקוחות
QUOTES MNG.==ניהול הצעות
CUSTOEMER COMPLAINTS MNG.==ניהול תלונות לקוחות
&INVENTORY==ספירת מלאי
INVENTORY==ספירת מלאי
STOCK ENTRY==כניסת מלאי
STOCK TRANSFER==העברת מלאי
STOCK MANAGEMENT==ניהול מלאי
&TECH SYS.==טכני
TECH SYS.==טכני
T&ECH SYS.==טכני
RAW MATERIALS==חומרי גלם
BATCH BOOKS==ספרי אב
MODIFICATION BOOKS==ספרי הפעלה
PLANT BATCH BOOK DEFINITION==הגדרת ספרי אב למפעל
GRADING DATA ENTRY==נתוני דירוג
GRADING TYPES==סוגי דירוג
&VIEW==הצג
VIEW==הצג
VIEW SHIP DOCKETS==תעודות משלוח
VIEW INVOICES==חשבוניות
VIEW RECEIPTS==קבלות
VIEW DEPOSITS==הפקדות
VIEW SUPP DOCKETS==תעודות ספקים
VIEW CASH CLOSE==יתרת מזומן
&REPORTS==דוחות
REPORTS==דוחות
CHECK PERSISTENCE==בדיקת רצף
DESIGNED REPORTS==תכנון דוחות
&CLOSING==יציאה
CLOSING==יציאה
C&LOSE==סגור
CLOSE==סגור
UPDATE==עדכון
DATA==נתונים
CONFIRM==אישור
COMPANIES==חברות
DETAILES==פרטים
BRANCHES==מפעלים
BATCH_TERMINALS==מסופי יצור
BATCH_UNITS==מערכות יצור
PHISICAL_SILOS==סילוסים פיזים
BATCH_UNIT_SILOS==סילוסי מערכת יצור
RAW MAT QNT==כמות חומר גלם
RAW MAT CODE==קוד חומר גלם
NUM==מספר
NUM==מספר
MANAGEMENT==ניהול
ENG  NAME==שם באנגלית
AUTHORIZED DEALED==עוסק מורשה
COMPANY CODE==קוד חברה
LAST BACKUP==גיבוי אחרון
LAST DAILY PROC==עיבוד יומי אחרון
VAT  00==מע"מ
VAT  01==*
VAT  10==*
VAT  11==*
WALK IN  CUST NO==מס' לקוח מזומן
WALK IN PRICE LIST==הסכם לקוח מזומן
ROUND RULE==אופן עיגול
ROUND FACT==*
CITY==עיר
ADDRESS==כתובת
ADD CITY ENG==עיר באנגלית
ADDRESS ENG==כתובת באנגלית
ZIP CODE==מיקוד
PREFIX==קידומת
PHONE1==טלפון
FAX==פקס
EMAIL==דוא"ל
NUMBER==מספר
PRODUCTION TYPE==סוג יצור
RAW MAT PERCENT==אחוז חומר גלם
BATCH UNIT NUMBER==מס' בקר יצור
PHISICAL SILO NUM==מס' סילו פיזי
ZOOM OUT==עלה רמה
ZOOM IN==רד רמה
DELETE GROUP==מחק קבוצה
NEW GROUP==הוספה
GENERATE==חולל
CODE==קוד
SEARCH==חפש
YOU HAVE REACHED THE UPPER LEVEL==הגעת לרמה הגבוהה ביותר
ITEMS==פריטים
&CLOSE==סגור
ITEM CODE==קוד פריט
UNDO==ביטול
UPDATE ITEM==עדכון פריט
DESCRIPTION ENGLISH==תיאור באנגלית
UNIT CODE==קוד היחידה
SHORT DESCRIPTION==תיאור קצר
SHORT DESCRIPTION ENG==קוד פריט בעידן
QNT DIS ITEM CODE==*
BASE FACTOR==פקטור בסיסי
UN TAXED==ללא מע"מ
SELL==מכירה
MAX QNT==כמות מקס.
MIN QNT==כמות מינ.
UNIT==יחידה
PKG SIZE==גודל אריזה
GENERAL==כללי
TRANSPORTATION GROUP :==קבוצת הובלה
PRODUCTION CODE==קוד יצור
WEIGH ON EXIT==שקילה ביציאה
WEIGH ON ENTRY==שקילה בכניסה
PRICE CALCULATION==חישוב מחיר
0 : NORMAL==0 : רגיל
1 : BY BASE ITEM==1 : לפי מוצר חליפי
2 : BY ITEMS INCLUDED==2 : לפי עץ מוצר
BASE ITEM DEFINITION==הגדרת פריט חליפי
BASE ITEM CODE :==קוד פריט חליפי
BASE ITEM QUANTITY :==יחס חליפי (1=1 ל-1)
ITEM_DESC==תיאור פריט
QNT==כמות
INVENTORY CALCULATION==חישוב מלאי
2 : BY ITEMS ASSEMBLE==2 : לפי עץ מוצר
REPLACEMENT==החלפה
ITEM DESC==תיאור פריט
PURCHASE==רכישה
UNIT==יחידה
PKG SIZE==גודל אריזה
SELECT ITEM==בחר פריט
INSERT ITEM NAME==הכנס שם פריט
CBX_CASE==*
BY NAME==לפי שם
BY CODE==לפי קוד
BY CLIENT==*לפי הסכם
OMNA SYSTEM DESIGNER==עיצוב מערכת אומנה
ASCII FILES MANAGEMENT==ניהול קבצי ASCII
IMPORT-EXPORT==יבוא-יצוא
PROGRAM EXECUTE==ביצוע תוכנית
MENU DESIGNER==תכנון תפריטים
OBJECTS INPUT DEFINITIONS==הגדרת אובייקטים לקליטה
USERS ADMINISTRATION==ניהול משתמשים
FONT MANAGEMENT==ניהול גופנים
TABLES MANAGEMENT==ניהול טבלאות
DATABASES MANAGEMENT==ניהול בסיסי נתונים
VIEW TABLE==הצג טבלה
QBF==שאילתות
PARAMS==פרמטרים
TABLES MANAGMENT==ניהול טבלאות
HISTOGRAM==היסטוגרמה
DEFAULT SQL==SQL ברירת מחדל
DO BATCH==ביצוע פעולה
COPY VALUES==העתקת ערכים
DELETE VALUES==מחיקת ערכים
TABLES LIST==רשימת טבלאות
TABLE TYPE==סוג טבלה
DESIGN FIELDS==שדות תכנון
REVERT FIRST TIME==שיחזור
DESIGN GRID==תכנון גריד
TYPE NO==קוד סוג
BOTTOM PANEL FIELDS==שדות לפנל התחתון
GRID FIELDS==שדות גריד
DESIGN DETAILS==פרטי תכנון
DETAILS - TOP FIELDS==שדות פרטים לפנל העליון
DETAILS - BOTTOM FIELDS==שדות פרטים לפנל התחתון
DB/SQL/BATCH/EXEC  TABLES INPUT TYPES==ניהול סוגים ומיקום שדות
REFRESH==רענן
TRAN TABLE==*
SQL TABLE==*
DB TABLE==*
EXEC SQL==*
DEFAULT SQL GRID==*
DEFAULT SQL DETAILS==*
TRAN TABLES  INPUT TYPES==הגדרת שדות לטבלאות עזר
CONTROL GRID==רשת בקרה
SQL TEXT==שאילתת SQL
CHECK==בדיקה
BUILD SQL==בנייה
PARAM 0==*
PARAM 1==*
PARAM 2==*
PARAM 3==*
PARAM 4==*
PARAM 5==*
PARAM 6==*
PARAM 7==*
PARAM 8==*
PARAM 9==*
PARAM 10==*
DETAILS==פרטים
SORT==סוג
AUTOSTART==התחל אוטומטית
CHECKS TRUCK==בדיקות משאית
TABLE DEFINITIONS==הגדרת טבלה
SELECT FIELDS==בחר שדות
ID ==קוד
PN_TABLEDESCRIPTION==תיאור הטבלה
PN_TYPE==סוג
TYPE ==סוג
OBJECT ==אובייקט
PN_TABLENAME==שם הטבלה
TABLE NAME ==שם הטבלה
PN_FIELDS==שדות
BRANCH FIELD ==שדה של מפעל
NUMBER FIELD ==שדה של מספר
SELECT DATABASE ==בחר בסיס נתונים
SELECT...==...בחר
TABLE WAS UPDATED SUCCESSFULLY ==הטבלה עודכנה בהצלחה
IS COMPANY==חברה
ENG NAME==שם באנגלית
VA 00==*
VAT 01==*
VAT 10==*
VAT 11==*
CITY ENG==עיר באנגלית
PHONE2==טלפון נוסף
FIRM ID==מס' חברה
WALK IN CUST_NO==מס' לקוח מזדמן
WALK IN PRICE_LIST==הסכם לקוח מזדמן
DESCPRIPTION==*
SORT GROUP ENTRY OBJ==*
OBJECT :==*
RELATION VALUE==*
VALUE DESC==*
AL NONE==*
AL TOP==*
AL CLIENT==*
AL LEFT==*
AL BOTTOM==*
UPDATE GROUP==עדכון קבוצה
NEXT CODE LEN==אורך קוד רמה הבאה
NEXT SELECT FROM TABLE==טבלת בחירה לרמה הבאה
LOCAL CODE LEN==אורך קוד נוכחי
OBJECT TYPE==סוג אובייקט
NEXT IS ITEM==רמה הבאה היא פריטים
GENERATE SUB GROUPS==חולל תת-קבוצות
SET THE ROUTH FIRLD FOR THE NEW GROUP==*
INNER LEVEL CODE LENGTH==אורך קוד רמה פנימית
INNER LEVEL SELECT TABLE==טבלת בחירה לרמה פנימית
LAST LEVEL==רמה אחרונה
LOCAL CODE==קוד מקומי
NEW ITEM==פריט חדש
QUANTITY DISCOUNT ==הנחה
PRC CALC==חישוב מחיר
BASE ITEM PRC==מחיר פריט בסיסי
BASE ITEM QNT PRC==*
INV CALC==חישוב חשבונית
BASE ITEM INV==מלאי פריט בסיסי
BASE ITEM QNT INV==*
DELETE ACCOUNT==מחק חשבון
NEW ACCOUNT==הוסף חשבון
SITE==אתר
RECALC==חשב
CUSTOMER OPERATIONS==פעילות לקוח
SUPPLIER OPERATIONS==פעילות ספק
FINANCE==כרטיס לקוח
CUST.==לקוח
SUPP.==ספק
OPEN_GRP==אסמכתאות פתוחות
CREDIT :==קבלות
DEBIT :==חשבוניות
OPENING BALANCE==יתרת פתיחה
ACCOUNT NO :==מספר חשבון
DUE_BALANCE==חריגה
BALANCE==יתרה
SITES==אתרים
DISTANCES==מרחקים
ACCOUNT==חשבון
WALKIN ==מזדמן
SUPPLIER CUSTOMER CODE==קוד ספק/לקוח
SITE NUMBER==מספר אתר
SITE DESCRIPTION==תיאור אתר
CONTRACT==הסכם
SITE ZONE==מיקום האתר
SITE NO==מספר אתר
CITY CODE==עיר
ZIP==מיקוד
POB==.ת.ד
CITY NAME==שם העיר
CREATION DATE==תאריך הקמה
LAST MODIFICATION DATE==תאריך שינוי אחרון
DEFAULT CUSTOMER DISTANCE==טווח ללקוח-בסיס
DEFAULT CARRIER DISTANCE==טווח למוביל-בסיס
DEFAULT TRIP TIME==זמן נסיעה-בסיס
LOCATION CODE==קוד ספק בעידן
GPS_NORTH==GPS צפון
GPS_WEST==GPS מערב
GPS_EAST==GPS מזרח
VAT TYPE==סוג מע"מ
NOW==עכשיו
EOM==סוף החודש
EOY==סוף השנה
BOM==תחילת החודש
BOY==תחילת השנה
DEFINE QBF==הגדר דוחות
QBF LIST==רשימת דוחות
REPORT NAME==שם הדוח
RUN==בצע
BY FILTER==*
RANGE FIELDS==טווח שדות
FIELD'S RANGE DEFINITIONS==הגדרת טווח שדות
FIELD==שדה
MIN==מינימום
LOGICAL OPERATION==אופרציה לוגית
MAX==מקסימום
GET RANGE==לקבל טווח
AND==*
OR==*
FIELDS LIST==שימת שדות
SORT_FIELDS==מיין שדות
SORT ORDER==סדר מיון
FIELDS==שדות
APPLY==אשר
NOT FOUND==לא נמצא
AFTER DESIGNING SAVE YOUR REPORT AS ==לאחר תכנון שמור את הדו"ח
SAVE ? == ? שמור
WALK IN==מזדמן
CLOSE PROGRAM==סגור תוכנית
ADD NEW RECORD==הוסף רשומה חדשה
SELECT BRANCH==בחר מפעל
SEARCH CUSTOMER==חיפוש לקוח
COUNTRY CODE==קוד מדינה
MO.==*
ID\PASSPORT==מס' ת.זהות
INSERT WALKIN CUSTOMER==הוספת לקוח מזדמן
ID / PASSPORT==מס' ת.זהות
CODE / NAME==שם/קוד
CITY ==עיר
CONTRACT LISTS==רשימת הסכמים
SIMPLE RAISE==התיקרות מחירים
COMPOSE A NEW CONTRACT==בניית הסכם חדש
&NEW==חדש
DELETE CURRENT CONTRACT==ביטול הסכם נוכחי
DE&LETE ==ביטול
UPDATE CURRENT CONTRACT==עדכון הסכם נוכחי
&UPDATE==עדכון
PRESS TO RAISE PRICE==לחץ התיקרות מחירים
&RAISE==התיקרות
RE&STORE==שיחזור
&CONTRACT LIST==רשימת הסכמים
CONTRACT ID==מספר הסכם
CONTRACT DESCRIPTION==תיאור הסכם
CONTRACT BRANCH==הסכם למפעל
CONTRACT CUSTOMER==הסכם לקוח
FIND ==חפש
CONTRACT NO ==מספר הסכם
CONTRACT NAME==שם ההסכם
CUSTOMER ==לקוח
&DETAILS==פרטים
CUSTOMER NAME==שם לקוח
CONTRACT NO'  && DESCRIPTION==מספר ותיאור ההסכם
GENERAL DETAIL==פרטים כלליים
TYPE==סוג
STATUS==סטאטוס
CREATED ON :==נוצר ב
PERIOD : ==תקופה
STATUS :==סטאטוס
TO:==עד
TYPE :==סוג
FROM:==מ
FINANCIAL DETAIL==פרטים כספיים
CURRENCY==מטבע
ACTIVE VER DATE :==גירסה נוכחית
DATE :==תאריך
PAYMENT TERMS==תנאי תשלום
ACTIVE VER :==גירסה נוכחית
LAST MODIFY DATE :==עדכון אחרון
BASE CONTRACT==הסכם בסיס
CURRENCY :==מטבע
PAYMENT TERMS :==תנאי תשלום
BASE CONTRACT :==הסכם בסיס
INDEX :==מדד
INDEX==מדד
PRICE INCLUDE VAT : ==מחיר כולל מע"מ
TRANSPORT TERMS==תנאי הובלה
MIN DAILY QNT==כמות לביטול הוב' חלקית
ALLOW SUPPLY NO PRICE==אספקה ללא מחיר
TRANS_CONTRACT==הסכם הובלה
&PRICES==מחירים
ITEM PRICE HISTORY==חירי פריט-היסטוריה
PRICE==מחיר
DISCOUNT TYPE==סוג הנחה
DISCOUNT==הנחה
VALID PRICE LIST :==מחירון/הסכם בתוקף
CUSTOMER NAME:==שם לקוח
LABELVER==*
CONTRACT NO  ==מס' הסכם
ITEM BRANCH:==למפעל
ITEM PAYMENT TERMS :==תנאי תשלום לפריט
ITEM DISCOUNT TYPE :==סוג הנחת פריט
ITEM BASE CONTRACT :==מהסכם
QUANTITY FOR DISCOUNT :==כמות להנחה
QUANTITY DISCOUNT TYPE :==סוג ההנחה
QUANTITY DISCOUNT PRICE :==הנחה\מחיר
ITEM :==פריט
LB_ITEM_PRICE==מחיר פריט
QUANTITY FOR DISCOUNT 1 :==כמות מדרגה ב להנחה
QUANTITY DISCOUNT TYPE 1==סוג ההנחה
QUANTITY DISCOUNT PRICE 1 :==הנחה\מחיר
QUANTITY DISCOUNT PROGRESIVE :==מדורגת/פרוגרסיבית
PRICE HISTORY==היסטוריה למחיר
ITEM BRANCH :==למפעל
LB_ITEM_PRICE_HIST==*
QUANTITY DISCOUNT TYPE 1 :==סוג ההנחה
QUANTITY DISCOUNT PRICE 1:==הנחה/מחיר
ITEM PRICE==מחיר פריט
ITEM DISCOUNT==הנחת פריט
CONTRACT LIST==רשימת הסכמים
CONTRACTS LIST==רשימת הסכמים
NONE==אין
CONTRACT : ==הסכם
CUSTOMER NAME : ==שם לקוח
EMPTY==ריק
PAYMENT_TERMS==תנאי תשלום
UPDATE CONTRACT==עדכון הסכם
SAVE==שמור
CONTRACT && CUSTOMER DETAIL==פרטי הסכם ולקוח
DESCRIPTION :==תיאור
ENGLISH DESCRIPTION :==תיאור באנגלית
NUMBER :==מספר
BRANCH :==מפעל
CUSTOMER :==לקוח
PRICE LIST DATE -TIME:==תאריך מדד בסיס
&GENERAL==כללי
REGULAR==רגיל
PERIOD :==תקופה
FROM :==מ
TO :==עד
GENERATE ==חולל
ITEMS GROUP :==קבוצת פריטים
LBL_GENERATE==ריק
GENERATE P/L==ביצוע
&FINANCIAL==כספי
ON DELIVERY==שוטף
SHEKEL==ש"ח
PRICE INCLUDE VAT :==מחיר כולל מע"מ
ACTIVE PRICE LIST NO :==מספר מחירון/הסכם בתוקף
CONTRACT DATE :==ת. חתימת הסכם
ALLOW SUP NO PRICE==אפשרות אספקה ללא מחיר
ITEM PRICE :==מחיר פריט
BASE CONT :==הסכם בסיס
DISC TYPE :==סוג הנחה
QNT DISC :==מעל מדרגה
QNT DISC TYPE :==סוג הנחה
QNT DISC PRICE :==הנחה
DISCOUNT :==הנחה
PAYMENT==תשלום
QNT DISC 1 :==מעל מדרגה
QNT DISC TYPE 1 :==סוג הנחה
QNT DISC PRICE 1 :==הנחה
BRANCH:==מפעל
ORAD==*
(NOT FOUND)==לא נימצא
ACTIVE==פעיל
MAIN TARIFF==תעריף עיקרי
DO YOU WANT TO RAISE CONTRACT NUMBER :==ברצונך לייקר מחירים בהסכם -
QUANTITY DISCOUNT TYPE 1:==סוג ההנחה
QUANTITY DISCOUNT PROGRESIVE==מדורגת/פרוגרסיבית
QNT DISC TYPE1 :==סוג הנחה
RAISE PRICE METHOD==שיטת התיקרות מחירים
SELECT HOW TO RAISE PRICES==בחר כיצד לייקר מחירים
RAISE AMOUNT==סכום העלאה
FROM DATE==מתאריך
RAISE DISCOUNT==עדכן הנחה
SUM==סכום
PERCENTAGE==אחוז
MANUAL==ידני
SELECTED ITEMS==פריטים נבחרים
TARIFF LIST==רשימת תעריפים
PROGRESSIVE==מתקדם
NOT PROGRESSIVE==לא מתקדם
FIXED RANGES==טווחים קבועים
TRANSPORT CONTRACT==הסכם הובלה
TRANS CONTRACT LIST==רשימת הסכמי הובלה
DATE==תאריך
ACTIVE VERSION==גירסה פעילה
VERSION DATE==תאריך גירסה
NO ==מספר
CONTRACT DATE ==תאריך הסכם
LAST MODIFICATION DATE ==תאריך שינוי אחרון
ACCOUNT ==חשבון
ACTIVE VERSION ==גירסה פעילה
ACTIVE VERSION DATE ==תאריך גירסה פעילה
CALC MODE ==אופן חישוב
1==*
2==*
3==*
WAIT TIME OVERRIDE==דריסת מוביל ע"י לקוח
INDEX TYPE ==סוג מדד
INDEX PERCENT ==אחוז התיקרות
DISPLAY VERSION ==הצגת גירסה
TRANSPORTATION COST==עלות הובלה
FIXED PER KM ==לפי ק"מ
FIXED PER UNIT ==לפי יחידה
PER UNIT * KM==יחידה לק"מ
PER UNIT*KM==יחידה*ק"מ
UP TO==עד
? ==?
ABOVE==מעל
TRANSPORTATION RANGES COST==עלות טווח הובלה
RANGE ==טווח
FIXED  ==קבוע
PER UNIT ==לפי יחידה
PLANT ==מפעל
ITEM ==פריט
WAIT BASE ==המתנה בסיסית
WAIT UNIT ==המתנה ליחידה
WAIT COST ==עלות המתנה לשעה
TRUCK TYPE ==סוג משאית
MIN QNT==כמות מינימלית
CALC PARTIAL==חישוב חלקי
PARTIAL_TRANSPORT COST ==עלות הובלה חלקית לכל קוב חסר
NEW VERSION==גירסה
RESTORE==שחזור
TRUCK==משאית
WAIT BASE==המתנה בסיסית
WAIT COST==עלות המתנה לשעה
WAIT UNIT==המתנה ליחידה
PART TRANS COST==עלות הובלה חלקית
CODE ==קוד
TRANS CONTRACT ==הסכם הובלה
NO VERSIONS TO RESTORE==אין גירסאות לחיחזור
VALUE==ערך
RECALCULATE THE COMPLEX INDEX ?==?האם לחשב מדד מורכב
SRC1==*
SRC2==*
SRC3==*
PERC1==*
PERC2==*
PERC3==*
DESC==תיאור
DRIVER==נהג
TRIPS==גיחות
IN WORK PLAN==בתוכנית עבודה
CURRENCY CODE==קוד מטבע
UNITS==יחידות
BUY RATE==שער קנייה
MID RATE==*
SELL RATE==שער מחירה
VIEW BY DATE==הצג לפי תאריך
VIEW BY CURRENCY==הצג לפי מטבע
EXECUTE PROGRAM==ביצוע תוכנית
EXECUTE==ביצוע
CONTRACT INDEX UPDATE==עדכון מדד ההסכם
UPDATE REDUCTIONS==עדכון הפחתות
UPDATE PRICES==עדכון מחירים
UPDATE REDUCTIONS AND PRICES==עדכון הפחתות ומחירים
INVOICE PRODUCTION==הפקת חשבונית
EXIT PROGRAM==יציאה מהתוכנית
&EXIT==יציאה
INVOICE DETAILS==פרטי חשבונית
CONTRACT ==הסכם
ACCOUNT SEARCH BY NAME==חיפוש לפי שם
INVOICE DATE ==תאריך חשבונית
WALKIN BRANCH ==מפעל לקוח מזדמן
PERIOD ==תקופה
START==התחל
END==סוף
CUSTOMER TYPE ==סוג לקוח
TRANSACTIONS==עסקאות
REFERENCE ==אסמכתה
INITIAL INVOICE FORM==*
DEBIT/CREDIT==זכות/חובה
SELECT ACCOUNT==בחר חשבון
ACCOUNT CODE==קוד חשבון
CUSTOMER DETAILES==פרטי לקוח
MIDDLE WORD==אמצע מילה
SELECT INVOICE==בחר חשבונית
CONTINUE==המשך
WALKIN BRANCH==מפעל לקוח מזדמן
RECEIPT DATE==תאריך קבלה
TOTAL AMOUNT==סה"כ
CASE SENSITIVE==רגיש לגודל אות
RANGE DEFINITION==הגדרת טווח
PERIOD==תקופה
PLANTS==מפעלים
FROM==מ
TO==עד
CUSTOMER RANGE==טווח לקוח
FROM ACCOUNT==מחשבון
TO ACCOUNT==עד חשבון
DEPOSIT BANK==הפקדה לבנק
EMPLOYEE NO==מספר עובד
TOTAL SUM==סה"כ
PAYMENT TYPE==אמצעי תשלום
PRIMARY==ראשי
SECONDARY==משני
MAIN NUMBER==מס' ראשי
SEC NUMBER==מס' משני
DUE DATE==תאריך פרעון
TOTALS==סה"כ
UNSELECTED==לא נבחר
SELECTED==נבחר
#==*
PAY TYPE==סוג תשלום
CASHABLE==מזומן
DELAYED==צ'קים דחויים
SECONDARY PAYMENT TYPE==אמצעי תשלום משני
SECONDARY NUMBER==מספר משני
PLEASE FILL BANK ACCOUNT==אנא הכנס חשבון בנק
UPDATE TARIFF==עדכון תעריף
NEW TARIFF==תעריף חדש
RECALCULATE SHIP DOCKETS==חישוב מחדש של ת. משלוח
PLANTS RANGE==טווח מפעלים
FROM PLANT==ממפעל
TO PLANT ==עד מפעל
FROM  :==מ
TO : ==עד
CALC PRICE==חישוב מחיר
CALC COST==חישוב עלות
RECALC CUSTOMER DISTANCE==חישוב מרחק לקוח
RECALC TRANSPORTER DISTANCE==חישוב מרחק הובלה
PROCESS==תהליך
OUTPUT==פלט
PROCESS CHARGE ORDERS==תהליך הוראות קבע
VIEW CHARGE ORDERS==הצגת הוראות קבע
EXPORT CHARGE ORDER==יצוא הוראות קבע
NO==מס'
TOTAL==סיכום
TO DATE==עד תאריך
CHARGE RECEIPTS==*
CLICK TO SHOW RECEIPT'S LINES==הקיש להצגת שורות קבלות
RECEIPT LINES==שורות קבלה
WALKIN CUSTOMER==לקוח מזדמן
ACCOUNT NO==מס' חשבון
AMOUNT==סכום
RECEIPTS NOT FOUND==לא נמצאו קבלות
CASH==מזומן
INCOME TYPE==סוג הכנסה
CURRENCY ==מטבע
SPECIAL==מיוחד
ACCOUNT TYPE==סוג חשבון
CREDIT ACCOUNT==חשבון זכות
DEBIT ACCOUNT==חשבון חובה
FROM BRANCH==ממפעל
TO BRANCH==עד מפעל
ACCOUNT TRANSACTION NO==מס' פקודת יומן
CLEAR==נקה
DO LINK==יצר קישור
DOCUMENTS==מסמכים
INTERNAL INVOICE==חשבונית פנימית
EXTERNAL INVOICE==חשבונית חיצונית
DEPOSIT==הפקדה
INTERNAL SUPPLIER INVOICE==חשבונית ספק פנימית
EXTERNAL SUPPLIER INVOICE==חשבונית ספק חיצונית
PLEASE INSERT ALL NECESSARY VALUES ==נא להכניס כל הערכים ההכרחים
LIST==רשימה
INSERT==הכנס
SITE ==אתר
CONTRACT ==הסכם
TRUCK NO ==מס' משאית
SELECT DRIVER ==בחר נהג
DRIVER NAME ==שם נהג
SELECT TRUCK ==בחר משאית
QNT ==כמות
RETURNED QNT==כמות חוזרת
EXTERNAL SUPP ==ספק חיצוני
RETURNED SHD PLANT==מפעל תעודת חוזר
RETURNED SHD==ת.מ. שהוחזרה
EXTERNAL==בטון קנוי
LEAVE SITE DATE ==תאריך עזיבת האתר
ARRIVE DATE ==תאריך הגעה
REQUEST DATE ==תאריך הזמנה
REQUEST TIME ==שעת הזמנה
ARRIVE TIME ==שעת הגעה
LEAVE SITE TIME ==שעת עזיבת האתר
SHIP DOCKET NUMBER ==מס' תעודת משלוח
MANUAL ==ידני
CUSTOMER ADDITIONS==תוספות ללקוח
ADD ITEM ==הוסף פריט
QUANTITY ==כמות
QUANTITY==כמות
PRODUCT==מוצר
FRM STOCK MANAGE==ניהול מלאי
BRANCH NO==מס' מפעל
BRANCH NAME==שם מפעל
SET INVENTORY RANGE==קביעת טווח ספירת מלאי
SELECT INVENTORY PERIOD==בחר תקופת ספירת מלאי
PROD TO STOCK==*
USED==שימוש
ENTRY==כניסה
STOCK==מלאי
STOCK TRANSACTIONS==מצב מלאי
NEW==חדש
MEASURED==מלאי בפועל
INV START DATE==תאריך תחילת ספירת מלאי
QNT START==מלאי התחלתי
QNT USED==שימוש מלאי
QNT ENTRY==כניסת מלאי
ADJUSTMENT==תיקון
QNT END==מלאי מחושב
INVENTORY DATE==תאריך ספירת מלאי
RAW MATERIAL==חומר גלם
STOCK TRAN==תנועות מלאי
RAW MATERIAL ==חומר גלם
GROUPS==קבוצות
DESCRIPTION  ==תיאור
DESCRIPTION ENG ==תיאור באנגלית
STOCK ==מלאי
UNIT ==יחידה
ENTRY ==כניסה
UNIT   ==יחידה
FACTOR  ==יחס
/==*
MAX  ==מקסימום
USAGE==שימוש
FACTOR==יחס
MIX ==תערובת
IN SILO==בסילו
WEIGHED==נשקל בכניסה
EXIT WEIGH==נשקל ביציאה
RELATIVE ==האם מוכפל בח"ג אחר
R. MAT  ==חומר גלם
STATUS ==סטאטוס
RESPONSIBLE GROUP==קבוצה אחראית
CEMENT MODIFICATION BOOKS ==ספרי הפעלה לצמנט
COPY==העתק
ITEM CODE ==קוד פריט
ITEM DESCRIPTION ==תיאור פריט
LAST VERSION ==גירסה אחרונה
TICKET==כרטיס
NO.==מספר
LAST VERSION==גירסה אחרונה
MIX==תערובת
HISTORY==היסטוריה
VERSION NO==מס' גירסה
BASE ITEM==פריט בסיס
WEIGH ORDER==סדר הטענה
DISCHARGE TYPE==סוג פריקה
ACTIVE DATE==תאריך פעיל
MODIFICATION DATE==תאריך שינוי
EMPLOYEE==עובד
EXPLAIN==הסבר
RAW MAT SOURCES==מקור חומרי גלם
DEFAULT PRICE ==מחיר ברירת מחדל
SELECT SUPPLIER==בחר ספק
BOOK NO==מס' ספר
SUPPLIER CODE==קוד ספק
PLANT CODE==קוד מפעל
DEFAULT PRICE==מחיר ברירת מחדל
BATCH TICKET==כרטיס קבוצה
MODIFICATION BOOK==ספר הפעלה
MAX DIF UP==סטיה מעל
MAX DIF DN==סטיה מתחת
GRD SPECIFICATION==קוד דירוג
QNT FOR MC==כמות למ"ק
MODIF. BOOK==ספר הפעלה
INCORRECT RAW MAT CODE==קוד חומר גלם לא נכון
BOOKS==ספרים
TICKET NO==מס' כרטיס
VERSION==גירסה
EXPLANATION==הסבר
MODIFICATIONS TICKET==כרטיס הפעלה
ITEM MASK==פריט
MODIFICATION==שינוי
TYPE DESCRIPTION==תיאור סוג
PLANT BATCH BOOKS==ספרי אב
MODIFIED ON==מותאם ל
PLANT ADDITIONS==תוספות
MODIFY==עדכון
SET PLANT BATCH BOOK==קביעת ספר אב למפעל
BATCH BOOK :==ספר אב
REMARK==הערה
BATCH UNIT==סוג בקר
INVALID SITE==אתר לא חוקי
GO==בצע
RANGE==טווח
VIEW TYPE==הצג סוג
FROM CUSTOMER :==מלקוח
TO CUSTOMER :==עד לקוח
FROM SITE :==מאתר
TO SITE :==עד אתר
TO DATE :==עד תאריך
FROM DATE :==מתאריך
FROM PLANT :==ממפעל
TO PLANT :==עד מפעל
TRANSPORTER :==מוביל
TRUCK :==משאית
PRODUCTION QUANTITIES==כמויות יצור
ADDITIONS==תוספות
TRUCK NO==מס' משאית
DRIVER CODE==קוד נהג
INVOICE BRANCH==חשבונית שייכת לחברה
INVOICE NO==מס' חשבונית
TRANSPORT==הובלה
CUST DIST==מרחק ללקוח
PARTIAL TRAN CUST==הובלה חלקית לקוח
CUST WAIT TIME==זמן המתנה ללקוח
TRAN WAIT TIME==זמן המתנה למוביל
FIXED PRICE==מחיר קבוע
EXTRA PRICE==מחיר מיוחד
TRANS PRICE==מחיר הובלה
WAIT PRICE==מחיר המתנה
ADDITIONALS PRICE==מחיר תוספות
FIXED TRANS COST==עלות הובלה קבועה
RAW MAT COST==עלות חומרי גלם
TRANS COST==עלות הובלה
ADDITIONALS COST==עלות תוספות
DISPATCHER==מסוף
BATCHER==מטעין
PROD UNIT==יחידת יצור
BATCH BOOK==ספר אב
RET SHD PLANT==מפעל החנת בטון שחזר
RET SHD NO==מס' ת.מ. בטון חוזר
RET QNT==כמות בטון חוזר
ADD WATER ON SITE==תוספת מים באתר
REQ TIME==זמן יציאה מתוכנן
START PROD==תחילת יצור
END PROD==סיום יציר
ARRIVE==הגעה
START PLACING==תחילת פריקה
LEAVE SITE==עזיבת אתר
RET TO PLANT==חזרה במפעל
EXTERNAL SUPP==ספק חיצוני
SHIP DOCKET MANAGMENT==ניהול ת. משלוח
BACK==קודם
NEXT==הבא
CHANGE DESTINATION==שינוי יעד
CREDIT==אשראי
IDENTIFICATION==זיהוי
SHIP DOCK ==ת. משלוח
DO CLOSE==בצע סגירה
ARRIVAL ==הגעה
START UNLOADING==תחילת פריקה
DEPARTURE ==עזיבה
RETURN TO PLANT==חזרה במפעל
CANCELING DETAILES==פרטי ביטול
DO CANCEL==בצע ביטול
EXPLAIN ==הסבר
NEW ORDER ==הזמנה חדשה
NEW PLANT ==מפעל חדש
CREDIT DETAILES==פרטי זיכוי
DO_CREDIT==בצע זיכוי
CREDIT QNT==זיכוי חלקי
WAITING TIME==זמן המתנה
PARTIAL CUSTOMER TRANS==הובלה חלקית לקוח
INVOICE VIEW==הצג חשבונית
&RANGE==טווח
CUST NO==מס' לקוח
SET SELECTION==ערוך בחירה
NEW SELECTION==בחירה חדשה
&INVOICE LIST==רשימת חשבוניות
PRINT ALL INVOICES==הדפס כל החשבוניות
UPDATE ==עדכון
PRINT INVOICE==הדפס חשבונית
I&NVOICE DETAILS==פרטי חשבונית
&LINES==שורות
LINES &DETAILS==פרטי שורות
LIN&K RECEIPTS==קישור לקבלה
RECEIPT TYPE==סוג קבלה
RECEIPT BRANCH==מפעל קבלה
RECEIPT NO==מס' קבלה
LINK AMOUNT==קישור לכמות
RECEIPT VIEW==הצג קבלה
&CANCEL INVOICE==ביטול חשבונית
REMARKS==הערות
CANCELED INVOICE==חשבונית מבוטלת
NEW INVOICE==חשבונית חדשה
CANCELING DATE==תאריך ביטול
CANCEL INVOICE==בטל חשבונית
INVOICE TOTAL==סה"כ חשבונית
TOTAL PAID==סה"כ לתשלום
CUS WALKIN==לקוח מזדמן
PERIOD START==תחילת תקופה
PERIOD END==סוף תקופה
REFERENCE TYPE 1==סוג אסמכתה 1
REFERENCE BRANCH 1==מפעל אסמכתה 1
REFERENCE NO 1==מס' אסמכתה 1
REFERENCE TYPE 2==סוג אסמכתה 2
REFERENCE BRANCH 2==מפעל אסמכתה
REFERENCE NO 2==מס' אסמכתה 2
AMOUNT UNTAXED==סכום ללא מע"מ
DISCOUNT TOTAL==ס"הכ הנחה
TAX PERCENTAGE==אחוז מע"מ
TAX TOTAL==סה"כ מע"מ
AMOUNT TOTAL==סה"כ סכום
PRICE LIST==רשימת מחירים
REF CURR==*
REF CURR RATE==*
ACC TRAN==*
AGENT==סוכן
THIS INVOICE IS FROM A DIFFERENT COMPANY !==! חשבונית זות מחברה שונה
RECEIPTS VIEW==הצג קבלות
REGULAR RECEIPTS==קבלות רגילות
SUPPLIER RECEIPTS==קבלות לספק
ALL==הכל
PRINT SOURCE==הודפס מקור
PAYED==שולם
ANNULLED==בוטל
PAYMENT ==תשלום
RECEIPTS LIST==רשימת קבלות
CANCEL RECEIPT==בטל קבלה
RECEIPTS DETAILS==פרטי קבלה
LINES==שורות
LINES DETAILS==פרטי שורות
REVERT==חזרה למצב קודם
INVOICES CONNECTED==קישור לחשבונית
TOTAL :==סה"כ
TOTAL REMAIN==סה"כ נישאר
LNK AMOUNT==סכום הקישור
INVOICE PAID==סכום מכוסה
INVOICE REMAIN==נשאר לא מכוסה
UNCONNECT==ניתוק
VIEW ==הצג
CONNECT==חיבור
UNCONNECTED INVOICES==חשבוניות לא מחוברות
CANCELING TYPE==סוג ביטול
CHARGE ITEM==סוג חיוב
CHARGE COST==עלות חיוב
CHARGE QNT==כמות חיוב
TOTAL CHARGE==סה"כ לחיוב
VALUE DATE==תאריך פירעון
CHARGE SOURCE : ==*
USE DUE DATE==זמן פירעון
DEPOSIT VIEW==הצג הפקדה
SELECTION==בחירה
NOT CANCELED ONLY==לא מבוטלות בלבד
CANCELED ONLY==מבוטלות בלבד
CANCEL DEPOSIT==בטל הפקדה
DEPOSIT DETAILS==פרטי הפקדה
DEPOSIT LINES==שורות הפקדה
DEPOSIT LINES DETAILS==פרטי שורות הפקדה
DEPOSIT BRANCH==הפקדה ממפעל
DEPOSIT NUMBER==מס' הפקדה
DEPOSIT DATE==תאריך הפקדה
BANK ACCOUNT==חשבון בנק
ACCOUNT TRN==תנועות חשבון
CASH CLOSING VIEW==הצג יתרת מזומן
PAYMENT_TYPE==סוג תשלום
CURRENCY_NAME==מטבע
PAYMENT TYPE\CURRENCY CLOSING==סוג תשלום/קביעת מטבע
IN==*
OUT==*
LAST_DATE==תאריך אחרון
OPERATION==פעולה
FROM...   ==מ
TO...   ==עד
DEFAULT==ברירת מחדל
LOCAL DISPATCHER==סדרן מקומי
NEW ORDER==חדשה
SHIP DOCKET==תעודת משלוח
UPD ORDER==עדכון
TRUCKS ==משאיות
NO TRUCK==ללא משאית
RETURN==חזרה
ACTIVE ORDERS ==הזמנות פעילות
SHIPING DOCKETS==תעודות משלוח
PRODUCTION ==יצור
PRODUCTION==יצור
MANUAL WAITING LIST==רשימת המתנה
TERMINALS==מסופים
ITEM MANAGEMENT==ניהול פריטים
SHIP DOCK==ת. משלוח
RECEIPT==קבלה
CUST==לקוח
ORDER NO.==מס' הזמנה
PRIORITY==עדיפות
QNT ORD==הוזמן
QNT SUPP.==סופק
SLUMP==סומך
DONE==בוצע
CUSTOMER ORDER==הזמנת אספקה ללקוח
CHANGE STATUS==שינוי סטאטוס
ORDER==הזמנה
PLACED BY ==הוזמן על-ידי
DATE ==תאריך
TIME ==זמן
INCLUDE TRANS==לכלול הובלה
PN_DISPATCHER==סדרן
REQUEST PLANT==הוזמן במפעל
FREQUENCY ==תדירות
PN_ITEM==פריט
ITEM==פריט
REMARK==הערה
STATUS==סטאטוס
TERMINATION ==סיום
CURRENT QNT==אספקה נוכחית
TERMINATE DATE TIME==שעת סיום
ORDER OPERATIONS==פעולות להזמנה
ORDER OPER TYPE==סוג פעולה
ORDERS ADDITIONS==תוספות להזמנה
REQUEST DATE==תאריך בקשה
QNT SUPPLIED==כמות לאספקה
CLOSE ORDER==לסגור
ORDER NO==מס' הזמנה
CUS.  CODE==קוד לקוח
CUS.  NAME==שם לקוח
OPER. CODE==קוד פעולה
OPER. TYPE==סוג פעולה
DATE TO DO==תאריך לאספקה
TRUCK NOT SELEDCTED==בחר משאית
INVALID TRUCK NO==מס' משאית שגוי
ORDER NOT SELECTED==בחר הזמנה
THE NEW MALL - ROSES AVN.==*
INVALID PRIORITY NO==עדיפות שגויה
REGIONAL ORDERS==סידור אזורי
BATCHING==יצור
TS_SHD_TEMP==המתנה ליצור
CALC==חשב
RETRIEVE==הצלה
SHIP DOCKETS==תעודת משלוח
WEIGH==שקילה
LOAD==עמסה
FORCE END==סיים מנה
CONFIG.==תצורה
CHANGE DISPATCHER TO LOCAL==שינוי סדרן למקומי
CUSTOMER ACCOUNT==חשבון לקוח
CUSTOMER NO==מספר לקוח
MAIN CUSTOMER CODE==קוד לקוח ראשי
ACCOUNTING CODE==קוד הנח"ש
STAT==סטאטוס
COLLECTOR==גובה תשלום
COLL==גובה
ASSOCIATION==שייך לאגודה
CUSTOMER TYPE==סוג לקוח
PAYMENT MODE==אופן תשלום
MODE==אופן
THE CITY==עיר
PHONE==טלפון
PHONE 2==טלפון נוסף
CONTACT PERSON==איש קשר
DELAYED CHEQUE==צ'ק דחויים
OPEN SHIPPING DOC==ת. משלוח לפני חשבונית
MAXIMUM CREDIT==תקרת אשראי
PRINT TYPE==סוג הדפסה
COPY NO==מספר עותקים
INVOICE DELIVERY TYPE==אופן משלוח חשבונית
BANK==בנק
BANK BRANCH==סניף בנק
BANK ACCOUNT NO==מספר חשבון בנק
ENTRY UNIT IS MISSING==נא למלא את כל פרטים
CODE EXIST==! המספר כבר קיים
ROOT==שורש
WORK PLAN==סידור עבודה
LEAVE==הוריד
TRANS==הובלה
< DEFAULT==< הכל
<  ENTRY==< הכנס
< OK==< אשר
TIME==זמן
LEAVE >==הוריד >
OK >==אשר >
ZONE==איזור
NO TRUCKS WHERE SENT TO WORK==*
ZONE IS MISSING !==! חסר אזור
ZONE DESCRIPTION==תיאור אזור
MASTER_DISPATCHER==סדרן הראשי
MASTER DISPATCHER NAME==שם סדרן הראשי
NO ACTION==*
GET TBL PARAMS==*
SQL==*
TABLE==טבלה
REPLACE PREVIOUS DESIGN ?!==!? להחליף תכנון קודם
SAVE CHANGES BEFORE GO ON ?!==!? לשמור שינוים לפני המשך
NO RIGHT TO UPDATE OR DELETE!==! אין הרשאה למחיקה או עדכון
RECORD NO==מס' רשומה
RCV_FNAME==קובץ קליתה מבקר
SEND_FNAME==קובץ שליחה לבקר
RCV_FILE_TYPE==סוג קובץ קליתה מבקר
RCV_TEMPLATE==תבנית קובץ קליתה
SEND_TEMPLATE==תבנית קובץ שליחה
W_END_FNAME==הודעת סיום מבקר
SEND_TBL==טבלת הסילוסים
COMM_DIR==מחיצת תקשורת עם בקר
TEMP SHIP DOCKET==ת.מ. זמנית
SHIP DOCKET DETAILES==פרטי ת. משלוח
BATCH BOOK ==ספר אב
DO WEIGH==שקילה
TECHNICAL ADDITIONS==תוספות טכניות
TRUCK IS ALLREADY OCCUPIED !==! המשאית בהעמסה
NONE (MANUAL)==המתנה
NONE (AUTOMATIC)== בחירה אוטומטית
NEW DESIGN IS SAVED !==! תכנון חדש נשמר
BRANCH_NO==מס' מפעל
CUSTOMER_NO==מס' לקוח
COUNTRY_CODE==קוד מדינה
ID_PASSPORT==ת. זהות
CUSTOMER_NAME==שם לקוח
CITY_CODE==קוד עיר
CITY_NAME==שם עיר
HANGES WHERE NOT SAVED IN GRID DESIGN! CONTINUE ?!==!? שינוים לא נשמרו בתכנון רשת, להמשיך
SQL BUILDER==מחולל SQL
SELECT FIELDS ==בחר שדות
AVAILABLE FIELDS ==שדות זמנים
FUNCTIONS  ==פונקציות
LINKS ==*
TABLE2==טבלה 2
FIELD2==שדה 2
CONST==*
TABLE1==טבלה 1
FIELD1==שדה 1
***************************************************************************
AT_COMPANY_CODE==מס' חברה
AT_TRN_NO==מס' פקודה
AT_CREATION_DATE==תאריך
AT_PERIOD_START==תחילת תקופה
AT_PERIOD_END==סוף תקופה
AT_TOTAL_CRE==*
AT_TOTAL_DEB==*
AT_REF_NO==*
AT_REF_DATE==*
***************************************
TL_COMPANY_CODE==חברה
TL_TRN_NO==מס. תנועה
TL_LINE_NO==מס. שורה
TL_TYPE==סוג
TL_ACC_NO==חשבון
TL_OPP_ACC_NO==*
TL_AMMOUNT==סכום
TL_CURR_CODE==*
TL_AMMOUNT_LC==*
TL_REF_TYPE==*
TL_REF_BRN==*
TL_REF_NO==*
TL_REF1_TYPE==*
TL_REF1_BRN==*
TL_REF1_NO==*
TL_DATE==תאריך
TL_VALUE_DATE==תאריך פירעון
TL_DETAILE==פרטים
***************************************
ACO_PLANT==מפעל
ACO_NUMBER==מס' הזמנה
ACO_DISPATCHER==מס' סדרן
ACO_REQ_DATE==שעת הזמנה
ACO_LAST_SUPP==אספקה אחרונה
ACO_NEXT_SUPP_REQ==אספקה הבאה
ACO_CALC_PRIORITY==*
ACO_ACTIVE==פעילה
***************************************
BBK_NO==מספר
BBK_DESCRIPTION==תיאור
BBK_STATUS==סטאטוס
BBK_RESPONSIBLE_GRP==סוג דירוג
BBK_SLUMP_MODIF_BOOK==*
BBK_CEMENT_ADD_MODIF_BOOK==*
BBK_RET_MODIF_0==*
BBK_RET_MODIF_10==*
BBK_RET_MODIF_20==*
BBK_RET_MODIF_30==*
BBK_RET_MODIF_45==*
BBK_RET_MODIF_60==*
BBK_RET_MODIF_75==*
BBK_LAST_MODIFICATION==תאריל עדכון אחרון
***************************************
BBI_BOOK_NO==*
BBI_CUST_CODE==*
BBI_ITEM_CODE==רוד פריט
BBI_MIN_SLUMP==*
BBI_MAX_SLUMP==*
BBI_LAST_VER==גירסה אחרונה
BBI_LAST_MODIF_DATE==תאריך עדכון אחרון
BBI_STATUS==*
***************************************
ID==מספר
LINE_NUMBER==*
DESCRIPTION==תיאור
PROGRAM==תוכנית
WINDOW_SIZE==*
BLINE_TYPE==*
BLINE_OPER_CODE==*
***************************************
ID==מספר
DESCRIPTION==תיאור
BATCH_FILE==*
WINDOW_SIZE==*
BATCH_PARAM==*
***************************************
BTP_ID==*
BTP_PARAM_NO==*
BTP_LABEL==*
BTP_PARAM_TYPE==*
BTP_SELECT_TBL_NUM==*
BTP_SEL_SQL==*
BTP_LOC_SQL==*
BTP_SEL_CODE_FNAME==*
BTP_SEL_DESC_FNAME==*
BTP_SEL_CODE_WIDTH==*
BTP_SEL_DESC_WIDTH==*
BTP_SEL_TOP==*
BTP_SEL_HEIGHT==*
BTP_SEL_WIDTH==*
BTP_SEL_LEFT==*
BTP_SEL_ORDER_BY==*
BTP_DEFAULT==*
BTP_SEL_STR_CODE==*
***************************************
BTT_PLANT==מס' מפעל
BTT_NUMBER==מס' מסוף
BTT_DESCRIPTION==תיאור
BTT_SHT_STATUS_FROM==סוג יצור מ -
BTT_SHT_STATUS_TO==סוג יצור עד
BTT_BB_MODIF_TYPE==אופן שמירת תיקון
BTT_AUTOSTART==*
BTT_SHD_PRINTER==מדפסת לתעודות
***************************************
BTU_PLANT==מס' מפעל
BTU_NUMBER==מס' בקר
BTU_DESCRIPTION==תיאור
BTU_PRODUCTION_TYPE==סוג יצור
BTU_CHECKS_TRUCK==בדיקת משאית
BTU_MOISTURE_ADJ_SILO==*
BTU_TMP_DISPATCHER==*
BTU_TMP_DATETIME==*
BTU_SH_DOCK_NUM==*
BTU_W_STAT==*
BTU_L_STAT==*
BTU_TERMINAL==מסוף
BTU_NO_OF_CHANNELS==כמות ערוצים
BTU_CHANNEL_TBL==טבלת הערוצים
BTU_MODIF_BOOK==ספר הפעלה
BTU_PROD_QNT_PER_HOUR==*
BTU_LOAD_TIME==*
BTU_BATCH_SIZE==*
BTU_ERROR_TBL==טבלת הודעות
***************************************
BBC_BOOK_NO==ספר אב
BBC_CUST_CODE==לקוח
BBC_ITEM_CODE==פריט
BBC_VER_NO==מס' גירסה
BBC_RM_CODE==חומר
BBC_MOD_BOOK==ספר הפעלה
BBC_QNT==כמות
BBC_MAX_DIFF_UP==סטיה מקס. למעלה
BBC_MAX_DIFF_DOWN==סטיה מקס. למטה
***************************************
BBM_BOOK_NO==אפר אב
BBM_ITEM_CODE==פריט
BBM_VER_NO==מס' גירסה
BBM_BASE_ITEM==פריט בסיס
BBM_WEIGH_ORDER==הזמנת שקילה
BBM_ACTIVE_DATE==תעריך פעילות
BBM_MODIF_DATE==תאריך שינוי
BBM_EMPLOYEE==עובד
BBM_EXPLAIN==הסבר
***************************************
BBS_BOOK_NO==ספר אב
BBS_RAW_MAT_CODE==חומר
BBS_SUPP_CODE==ספק
BBS_PLANT_CODE==מפעל
BBS_DEFAULT_PRICE==מחיר
***************************************
B_P_NUM==מספר מפעל
B_P_IS_COMPANY==מס' הסניף
B_P_NAME==שם מפעל
B_P_ENG_NAME==שם באנגלית
B_P_VAT_00==מע"מ ללקוח מקומי-במטבע מקומי
B_P_VAT_01==מע"מ ללקוח זר-במטבע מקומי
B_P_VAT_10==מע"מ ללקוח מקומי-במטבע חוץ
B_P_VAT_11==מע"מ ללקוח זר-במטבע חוץ
B_P_ZONE==אזור
B_P_CITY==עיר
B_P_ADDRESS==כתובת
ADD_CITY_ENG==עיר באנגלית
B_P_ADDRESS_ENG==כתובת באנגלית
B_P_ZIP_CODE==מיקוד
B_P_PREFIX==קידומת
B_P_PHONE1==טלפון
B_P_PHONE2==טלפון נוסף
B_P_FAX==פקס
B_P_EMAIL==דוא"ל
B_P_AUTHORIZED_DEALED==עוסק מורשה
B_P_FIRM_ID==מספר חברה
B_P_WALK_IN_CUST_NO==מס' לק' מזדמן
B_P_WALK_IN_PRICE_LIST==הסכם לק' מזדמן
B_P_COMPANY_CODE==חברה אליה שייך המפעל
B_P_LAST_BACKUP==גיבוי אחרון
B_P_LAST_DAILY_PROC==עיבוד יומי אחרון
B_P_ROUND_RULE==אופן עיגול
B_P_ROUND_FACTOR==המספר לעגל אליו
B_P_LOCATION_CODE==*
B_P_GPS_N==*
B_P_GPS_W==*
B_P_VAT_ACC_CRE==חשבון מע"מ עסקאות
B_P_VAT_ACC_DEB==חשבון מע"מ רכישות
B_P_DISCOUNT_ACC==חשבון הנחות
B_P_CASH_CLOSE_BRANCH==מס' סניף להפקדה
B_P_LAST_BACKUP==גיבוי אחרון
***************************************
BUS_PLANT==מפעל
BUS_BU_NUMBER==מס' בקר
BUS_NUM==מס' סילו
BUS_WGH_CHN_NUM==ערוצ שקילה
BUS_LOGICAL_NUM==מס' לוגי
BUS_DESCRIPTION==תיאור
BUS_PHISICAL_SILO_NUM==סילו פיזי
BUS_RAW_MAT_PERCENT==אחוז חומרי גלם
BUS_ADJUSTMENT_METHOD==שיטת תיקון
BUS_ADJUSTMENT_FACTOR==גורם תיקון
BUS_REQ_QNT==*
BUS_REQ_QNT_TOTAL==*
BUS_WGH_ORDER==*
BUS_BASE_REQ_QNT==*
BUS_ACTUAL_QNT==*
BUS_ACTUAL_QNT_TOTAL==*
BUS_HUMIDITY_CHECK==בדיקת לחות
BUS_HUMIDITY_PERCENT==אחוז לחות
BUS_RAW_MAT==חומר גלם
BUS_SCREEN_SIZE==משקל סילו מקסימלי (KG)
BUS_PROD_MULT==הכפלה לבקר
BUS_PROD_DIV==חילוק לבקר
BUS_TARGET_QNT==*
BUS_TARGET_QNT_TOTAL==*
***************************************
CA_INCOME_TYPE==*
CA_CURR_CODE==*
CA_BRANCH==*
CA_ACCOUNT==*
***************************************
CSHC_BRANCH==*
CSHC_DATE==*
CSHC_BDATE==*
CSHC_PAYMENT==*
CSHC_CURR==*
CSHC_START_AMMOUNT==*
CSHC_RCVD_AMMOUNT==*
CSHC_DEPOSIT_AMMOUNT==*
CSHC_PAYED_AMMOUNT==*
CSHC_CLOSE_AMMOUNT==*
***************************************
CSH_OPER_BR==סניף פעולה
CSH_OPER_NO==מס' פעולה
CSH_OPER_DATE==תאריך פעולה
CSH_BANK_ACC==הבנק המקבל
CSH_EMPLOYEE==עובד
CSH_TOTAL==סה"כ
CSH_ACCOUNT_TRN==מס' פקודות יומן
CSH_OPER_STATUS==סטאטוס
***************************************
CO_COMPANY==חברה
CO_NUMBER==מספר
CO_TYPE==סוג
CO_DATE==תאריך
***************************************
CRQ_NUMBER==*
CRQ_TERMINAL==*
CRQ_CREATE==*
CRQ_DO==*
CRQ_STATION==*
CRQ_OP_CODE==*
CRQ_PARAM1==*
CRQ_PARAM2==*
CRQ_PARAM3==*
CRQ_RETRIES==*
***************************************
CNP_CUST_CODE==לקוח
CNP_SITE_CODE==אתר
CNP_QUOTE_ID==הצעה
CNP_CODE==מספר
CNP_FNAME==שם
CNP_LNAME==משפחה
CNP_PHONE_1==טלפון
CNP_PHONE_2==טלפון נוסף
CNP_EMAIL==דוא"ל
CNP_MOBILE_PHONE==נייד
CNP_POSITION==תפקיד
CNP_REMARK==הערה
CNP_STATUS==סטאטוס
***************************************
CTR_NUMBER==מס' הסכם
CTR_DESCRIPTION==תיאור
CTR_DESCRIPTION_ENG==תיאור באנגלית
CTR_BRANCH==מפעל
CTR_CUSTOMER==לקוח
CTR_DATE==תאריך ההסכם
CTR_START_DATE==תהריך הפעלה
CTR_END_DATE==תאריך סיום
CTR_CREATED_ON==תאריך הקמת ההסכם
CTR_BASE_CONT==הסכם בסיס
CTR_CURR==מטבע
CTR_STATUS==סטאטוס
CTR_TYPE==סוג
CTR_PRICE_INCLUDE_VAT==כולל מע"מ
CTR_INDEX_TYPE==סוג מדד
CTR_INDEX_PERCENT==אחוז התיקרות
CTR_PAYMENT_TERMS==תנאי תשלום
CTR_TRANS_CONT==הסכם הובלה
CTR_MIN_DAILY_QNT==*
CTR_ALLOW_SUP_NO_PRICE==*
CTR_ACTIVE_VER==גירסה פעילה
CTR_ACTIVE_VER_DATE==תאריך גירסה פעילה
CTR_LAST_MODIF_DATE==תאריך עדכון האחרון
CTR_XMT_STATUS==*
CTR_AUTO_INDEX==*
***************************************
BRANCH==*
COUNTER_TYPE==סוג מונה
COUNTER_DESCRIPTION==תיאור מונה
COUNTER_VALUE==ערך
***************************************
CRT_CURR_CODE==*
CRT_DATE==*
CRT_UNITS==*
CRT_BUY_RATE==*
CRT_MID_RATE==*
CRT_SELL_RATE==*
***************************************
CMP_ID==מספר
CMP_BRANCH==מפעל
CMP_ACCOUNT==לקוח
CMP_WI_CUST_CODE==*
CMP_SITE_CODE==אתר
CMP_DEST_CODE==יעד
CMP_DATETIME==תאריך
CMP_ENTRY_DATETIME==תאריך הכנסה
CMP_ENTERED_BY==הוכנס ע"י
CMP_ORDER_PLANT==מפעל הזמנה
CMP_ORDER_NUMBER==מס' הזמנה
CMP_TICKET_PLANT==מפעל כרטיס
CMP_TICKET_NUMBER==מס' כרטיס
CMP_QCS_SAMPLE_ORDER==הזמנת מדגם
CMP_QCS_SAMPLE==מס' מדגם
CMP_ITEM_CODE==פריט
CMP_TYPE==סוג
CMP_STATUS==סטאטוס
CMP_ACTIVE==פעיל
CMP_DESCRIPTION==תיאור
CMP_RESPONSIBLE_EMPLOYEE==אחראי
***************************************
CSC_ID==מספר
CSC_BRANCH==סניף
CSC_PREV_STATUS==סטאטוס קודם
CSC_NEW_STATUS==סטאטוס חדש
CSC_ACTIVE_DATE==תאריך הפעלה
CSC_CHANGE_DATE_TIME==תאריך שינוי
CSC_EMPLOYEE_CODE==המבצע
CSC_REMARK==הערה
***************************************
CCNT_CUSTOMER==לקוח
CCNT_SITE_CODE==אתר
CCNT_CONTACT_PERSON==איש קשר
CCNT_CONTACT_PERSON_NAME==שם איש קשר
CCNT_TYPE==סוג
CCNT_REFERENCE_ID==מס' אסמכתה
CCNT_DATETIME==תאריך
CCNT_ENTRY_DATETIME==תאריך הכנסה
CCNT_EMPLOYEE==מטופל ע"י
CCNT_ENTERED_BY==הוקם ע"י
CCNT_OPERATION_TYPE==סוג פעולה
CCNT_REMARK==הערה
CCNT_FOLLOW_UP_DATE==תאריך למעכב
****************************************
COL1==*
COL2==*
COL3==*
COL4==*
***************************************
MY_INT==*
MY_FILE_NAME==*
***************************************
GRS_CODE==קוד דירוג
GRS_DESCRIPTION==תיאור
GRS_MAX_G0==*
GRS_MAX_G1==*
GRS_MAX_G2==*
GRS_MAX_G3==*
GRS_MAX_G4==*
GRS_MAX_G5==*
GRS_MAX_G6==*
GRS_MAX_G7==*
GRS_MAX_G8==*
GRS_MAX_G9==*
GRS_MAX_G10==*
GRS_MAX_G11==*
GRS_MAX_G12==*
GRS_MIN_G0==*
GRS_MIN_G1==*
GRS_MIN_G2==*
GRS_MIN_G3==*
GRS_MIN_G4==*
GRS_MIN_G5==*
GRS_MIN_G6==*
GRS_MIN_G7==*
GRS_MIN_G8==*
GRS_MIN_G9==*
GRS_MIN_G10==*
GRS_MIN_G11==*
GRS_MIN_G12==*
GRS_OPT_G0==*
GRS_OPT_G1==*
GRS_OPT_G2==*
GRS_OPT_G3==*
GRS_OPT_G4==*
GRS_OPT_G5==*
GRS_OPT_G6==*
GRS_OPT_G7==*
GRS_OPT_G8==*
GRS_OPT_G9==*
GRS_OPT_G10==*
GRS_OPT_G11==*
GRS_OPT_G12==*
GRS_WGT_0==*
GRS_WGT_1==*
GRS_WGT_2==*
GRS_WGT_3==*
GRS_WGT_4==*
GRS_WGT_5==*
GRS_WGT_6==*
GRS_WGT_7==*
GRS_WGT_8==*
GRS_WGT_9==*
GRS_WGT_10==*
GRS_WGT_11==*
GRS_WGT_12==*
***************************************
INX_CODE==*
INX_DESCRIPTION==*
INX_TYPE==*
INX_SRC1==*
INX_PERCENT1==*
INX_SRC2==*
INX_PERCENT2==*
INX_SRC3==*
INX_PERCENT3==*
***************************************
NXV_CODE==*
NXV_DATE==*
NXV_VALUE==*
***************************************
INV_PLANT_NUMBER==מס. מפעל
INV_RAW_MAT==חומר גלם
INV_SILO_NUMBER==מס. סולו
INV_DATE_TIME==תאריך סגירה
INV_LAST_INV_DATE==תאריך סגירה קודמת
INV_QNT_START==כמות קודמת
INV_QNT_ENTRY==כניסת חומרים
INV_QNT_USED==שימוש חומרים
INV_QNT_MEASURED==מלאי בפועל
INV_QNT_ADJUSTMENT==תיקון
INV_QNT_END==מלאי מחושב
***************************************
INV_TYPE==סוג חשבונית
INV_BRANCH_NO==מס' מפעל
INVOICE_NO==מס' חשבונית
INVOICE_DATE==תאריך חשבונית
INVOICE_DUE_DATE==תאריך פרעון
INV_CUS_WALKIN==האם לקוח מזדמן
INV_WALKIN_BRANCH==מס' מפעל לקוח מזדמן
INV_ACCOUNT_NO==מס' לקוח
PERIOD_START==תחילת תקופת החשבונית
PERIOD_END==סוף תקופת החשבונית
REFERENCE_TYPE_1==סוג האסמכתא
REFERENCE_BRANCH_1==מפעל האסמכתא
REFERENCE_NO_1==מס' האסמכתא
REFERENCE_TYPE_2==סוג מקור מבוטל
REFERENCE_BRANCH_2==סניף מקור
REFERENCE_NO_2==מסםר מקור
INV_CURRENCY_CODE==מטבע החשבונית
AMOUNT_TOTAL==סה"כ הכללי
AMOUNT_UNTAXED==סה"כ לפני מע"מ אחרי ההנחה
DISCOUNT_TOTAL==סה"כ ההנחה
TAX_PERCENTAGE==אחוז מע"מ
TAX_TOTAL==סה"כ מע"מ
TAX1_PERCENTAGE==*
TAX1_TOTAL==*
TAX2_PERCENTAGE==*
TAX2_TOTAL==*
TAX3_PERCENTAGE==*
TAX3_TOTAL==*
INV_SITE_NUMBER==מס' אתר
INVOICE_TOTAL==סה"כ חשבונית
INV_TOTAL_PAID==סה"כ שולם
INV_STATUS==סטאטוס חשבונית
INV_PRICE_LIST==מחירון
INV_REF_CURR==מטבע המחירון
INV_REF_CURR_RATE==שער המטבע
INV_EMPLOYEE==הוקמה ע"י
INV_ACC_TRAN==מס' פקודת יומן
INV_AGENT==סוכן העסקה
***************************************
INVL_TYPE==סוג
INVL_BRANCH==סניף/מפעל
INVL_INVOICE_NO==מס' חשבונית
INVL_LINE_NO==מס' שורת חשבונית
INVL_BRANCH_NO==מס' סניף/מפעל
INVL_QUANTITY==כמות
INVL_ITEM_CODE==קוד פריט
INVL_ITEM_LIST_PRICE==מחירון/הסכם
INVL_ITEM_PRICE==מחיר פריט
INVL_TOTAL_PRICE==סה"כ מחיר
INVL_TAXED==קיום מע"מ
INVL_DISCOUNT==הנחה
INVL_REFERENCE_TYPE_1==*
INVL_REFERENCE_BRANCH_1==לקוח
INVL_REFERENCE_NO_1==הסכם
INVL_REFERENCE_TYPE_2==סוג שורה
INVL_REFERENCE_BRANCH_2==מפעל
INVL_REFERENCE_NO_2==ת. משלוח
***************************************
INVLD_TYPE==סוג
INVLD_BRANCH==סניף
INVLD_INVOICE_NO==מספר
INVLD_LINE_NO==שורה
INVLD_DESCRIPTION==הסבר
***************************************
INC_INV_TYPE==*
INC_BRANCH_NUMBER==*
INC_INV_NUMBER==*
INC_OLD_PAY_TYPE==*
INC_NEW_PAY_TYPE==*
INC_OLD_DUE_DATE==*
INC_NEW_DUE_DATE==*
INC_EMP_CODE==*
INC_DATETIME==*
***************************************
LNK_INV_TYPE==*
LNK_INV_BRANCH_NO==*
LNK_INVOICE_NO==*
LNK_RCT_TYPE==*
LNK_RCT_BRANCH_NO==*
LNK_RCT_NO==*
LNK_AMOUNT==*
***************************************
ITEM_CODE==קוד פריט
GROUP_CODE==קוד קבוצה
DESCRIPTION==תיאור
SHORT_DESCRIPTION==תיאור מקוצר
DESCRIPTION_ENG==תיאור אנגלי
SHORT_DESCRIPTION_ENG==קוד פריט בעידן
OBJECT_NO==מס' אובייקט
UN_TAXED==*
ITM_UNIT_CODE==קוד יח. משקל
ITM_QNT_DISCOUNT_ITEM_CODE==*
ITM_PRC_CALC==חישוב מחיר
ITM_BASE_ITEM_PRC==*
ITM_BASE_ITEM_QNT_PRC==*
ITM_INV_CALC==*
ITM_BASE_ITEM_INV==*
ITM_BASE_ITEM_QNT_INV==*
ITM_MAX_QNT==כמות מקסימום
ITM_MIN_QNT==כמות מינימום
ITM_SELL_UNIT==*
ITM_SELL_PKG_SIZE==*
ITM_PURCHASE_UNIT==*
ITM_PPRC_CALC==*
ITM_PBASE_ITEM_PRC==*
ITM_PBASE_ITEM_QNT_PRC==*
ITM_PINV_CALC==*
ITM_PBASE_ITEM_INV==*
ITM_PBASE_ITEM_QNT_INV==*
ITM_PMAX_QNT==*
ITM_PMIN_QNT==*
ITM_PURCHASE_PKG_SIZE==*
ITM_TRNS_COST==*
ITM_BASE_FACTOR==*
ITM_CUSTOMER==*
ITM_PRODUCTION_CODE==קוד יצור
ITM_WEIGH_ON_EXIT==*
ITM_WEIGH_ON_ENTRY==*
ITM_TRNS_GRP_C==קבוצת עלות הובלה
ITM_TRNS_GRP_T==*
ITM_IN_TANK==*
***************************************
IA_BRANCH_STATION==*
IA_ITEM_CODE==*
IA_ACCOUNT_NO==*
IA_DEB_NRML==*
IA_CRE_NRML==*
IA_DEB_UNTAXED==*
IA_CRE_UNTAXED==*
IA_DEB_FRN==*
IA_CRE_FRN==*
IA_DEB_FIX==*
IA_CRE_FIX==*
***************************************
ITMA_MAIN_ITEM_CODE==*
ITMA_ASSEMBLED_ITEM==*
ITMA_ASSEMBLED_QNT==*
ITMA_TYPE==*
***************************************
ITMI_MAIN_ITEM_CODE==*
ITMI_INCLUDED_ITEM==*
ITMI_INCLUDED_QNT==*
ITMI_TYPE==*
***************************************
ITMR_MAIN_ITEM_CODE==*
ITMR_TYPE==*
ITMR_REPLACED==*
***************************************
GROUP_CODE==קוד קבוצה
LOCAL_CODE==*
LOCAL_CODE_N==*
FATHER_CODE==*
DESCRIPTION==תיאור
SHORT_DESCRIPTION==תיאור קצר
DESCRIPTION_ENG==*
SHORT_DESCRIOPTION_ENG==*
OBJECT_NO==מס' אובייקט
OBJECT_TYPE==סוג אובייקט
NEXT_KEY_LEN==*
NEXT_IS_ITEM==*
NEXT_SELECT_FROM_TAB==*
PICTURE==תמונה
***************************************
ITS_BBK_NO==*
ITS_ITEM_CODE==*
ITS_DATE==*
ITS_SPEC_CODE==*
ITS_REMARK==*
***************************************
IT_STATION_NO==*
IT_ITEM_CODE==*
IT_SHORT_ITEM_CODE==*
*************************************
LN_ID==מספר
LN_STATUS==סטאטוס
LN_ACTIVE==פעיל
LN_REMARK==הערה
LN_CUST_CODE==קוד לקוח
LN_TYPE==סוג
LN_ENTRY_DATETIME==תאריך הכנסה
LN_MODIF_DATETIME==תאריך שינוי
LN_REAL_AMOUNT==סכום
LN_CALC_AMOUNT==סכום מחושב
LN_ACTIVE_DATE==תאריך פעיל
LN_ENTER_BY==הוכנס ע"י
LN_MODIF_BY==שונה ע"י
LN_REFERENCE==אסמכתה
ות על בטחונות  ************************
LNO_ID==מספר
LNO_ENTRY_DATETIME==תאריך הכנסה
LNO_ACTIVE_DATETIME==תאריך פעיל
LNO_PREV_STAT==סטאטוס קודם
LNO_NEW_STAT==סטאטוס חדש
LNO_OPER_TYPE==סוג הפעלה
LNO_REMARK==הערה
LNO_ENTER_BY==הוכנס ע"י
*************************************
MNU_ID==מס' תפריט
MNU_DESCRIPTION==תיאור
MNU_PIC_DIR==*
***************************************
MNL_MENU_ID==מס' תפריט
MNL_MENU_GROUP==קבוצת תפריט
MNL_ICON_NAME==שם אייקון
MNL_DESCRIPTION==תיאור
MNL_FATHER_GROUP==קבוצת אב
MNL_TYPE==סוג
MNL_OP_CODE==*
MNL_PARAM==*
***************************************
MSG_NUMBER==מס' הודעה
MSG_ENTER_BY==נשלחה ע"י
MSG_DESTINATION==עבור
MSG_ENTER_DATE==תאריך שליחה
MSG_TO_DO_DATE==תאריך לביצוע
MSG_TYPE==סוג
MSG_DESCRIPTION==תיאור
MSG_OPER_DATE==תאריך ביצוע
MSG_CREATED_BY==נוצר ע"י
MSG_OPER_DESCRIPTION==תיאור ביצוע
MSG_STATUS==סטאטוס
***************************************
MBK_NO==מספר
MBK_DESCRIPTION==תיאור
MBK_CREATED_ON==*
MBK_LAST_MODIF_ON==*
MBK_LAST_VER==*
MBK_RESPONSIBLE_GRP==*
MBK_OPER_TYPE==*
***************************************
MDO_NO==*
MDO_VER==*
MDO_ITEM_MASK==*
MDO_RAW_MAT_GRP==*
MDO_MODIF_TYPE==*
MDO_MODIF==*
MDO_SET_OFF_RMG==*
MDO_SET_OFF_RATIO_DIV==*
MDO_SET_OFF_RATIO_MUL==*
***************************************
MDT_NO==*
MDT_VER==*
MDT_ACTIVE_DATE==*
MDT_CREATE_DATE==*
MDT_EMPLOYEE==*
MDT_EXPLAIN==*
***************************************
MDF_TEST_ID==*
MDF_FLD_ID==*
MDF_MSR_TYPE==*
MDF_FLD_DESC==*
MDF_FLD_LABEL==*
MDF_FLD_HINT==*
MDF_FLD_POS_TOP==*
MDF_FLD_POS_LEFT==*
MDF_FLD_HEIGHT==*
MDF_FLD_LENGTH==*
MDF_FLD_COLOR==*
MDF_FLD_TYPE==*
MDF_SLCT_TBL==*
MDF_CHECK==*
MDF_INPUT==*
MDF_BATCH_OPER==*
MDF_EXCEL_POS_INPUT==*
MDF_EXCEL_POS_CHECK==*
MDF_FLD_RANGE_MIN==*
MDF_FLD_RANGE_MAX==*
MDF_FLD_LBL_POS_TOP==*
MDF_FLD_LBL_POS_LEFT==*
MDF_FLD_LBL_HEIGHT==*
MDF_FLD_LBL_LENGTH==*
MDF_FLD_FONT==*
MDF_FLD_LBL_FONT==*
***************************************
MDF_ID==מס'
MDF_DESCRIPTION==תיאור
MDF_CREATED_BY==יוצר ע"י
MDF_GROUP==קבוצה
MDF_DATETIME==תאריך
***************************************
PMD_ID==מס'
PMD_ITEM_CODE==פריט
PMD_PLANT==מפעל
PMD_MODIF_TYPE==סוג
PMD_ROUND_TO==עיגול
PMD_MODIF==התיקרות
***************************************
OBJECT_TYPE==סוג אובייקט
OBJECT_NAME==שם אובייקט
***************************************
OBJECT_TYPE_9001==*
MAIN_CODE==*
DATA_TYPE==*
DATA_INPUT_DEF_CODE==*
DATA_INPUT_DEF_CODE_G==*
DATA_INPUT_DEF_CODE_D==*
SINGLE_MULTIPLE==*
DESCPRIPTION==תיאור
***************************************
COR_PLANT==מפעל
COR_NUMBER==מספר
COR_CREATE_DATE==תאריך
COR_PLACED_BY==*
COR_REFERENCE==אסמכתה
COR_DISPATCHER==סדרן
COR_REQ_DATE==תאריך הזמנה
COR_REQ_PLANT==הוזמן במפעל
COR_FREQ==*
COR_TERMINATE_DATETIME==*
COR_PRIORITY==עדיפות
COR_WALKIN_BRANCH==סניף לקוח מזדמן
COR_CUST_CODE==מס' לקוח
COR_CONTRACT==הסכם
COR_SITE==אתר
COR_ITEM==פריט
COR_EXTRA_FACTOR==*
COR_TERMINATION==סיום
COR_CURR_QNT==אספקה נוכחית
COR_ACTIVE==הזמנה פעילה
COR_INCLUDE_TRANS==*
COR_SHIP_PLAN==ת.מ. ממפעל
COR_REMARK==הערה להזמנה
COR_UPDATE_CENTER==*
COR_CREATED_BY==הוקם ע"י
COR_ORDER_NUM==מספר הזמנה
COR_REQ_DATE==תאריך אספקה
COR_CLIENT_NAME==פרטי לקוח
COR_CLIENT_NUMBER==מספר טלפון
***************************************
ORP_PLANT==מפעל
ORP_NUMBER==מספר
ORP_DATE_TO_DO==תאריך ושעה
ORP_OPER_TYPE==סוג פעולה
ORP_EXPLAIN==הסבר
ORP_DONE==בוצע
ORP_DONE_ON==בוצע ב
ORP_DONE_REGISTRATION==רישום ביצוע
ORP_DONE_BY==בוצע ע"י
***************************************
CORA_PLANT==*
CORA_NUMBER==*
CORA_CODE==*
CORA_ITEM==*
CORA_QNT==*
CORA_EXPLAIN==*
***************************************
PHS_PLANT==מפעל
PHS_NUM==מספר
PHS_DESCRIPTION==תיאור
PHS_RAW_MAT_BASE==חומר בסיס
PHS_RAW_MAT_CODE==קוד חומר גלם
PHS_RAW_MAT_QNT==כמות חומר גלם
PHS_ADJ_OPER_BOOK==ספר הפעלה לתיקון
PHS_ADJ_OPER_QNT==כמות הפעלות
PHS_LAST_INVENTORY==ספירת מלאי אחרונה
PHS_LAST_PROD_TO_INV==*
PHS_MAX_QNT==כמות מקסימום
PHS_MIN_PERCENT==אחוז מינימום
PHS_FULL_PERCENT==אחוז מלא
PHS_MODIF_GROUP==קבוצת שינוי
***************************************
PLB_PLANT==מפעל
PLB_PERIOD_START==*
PLB_BATCH_BOOK_NO==מס' ספר אב
PLB_MODIF_BOOK_NO==מס' ספר הפעלה
PLB_DATE_OF_MODIF==*
PLB_MODIFIED_BY==*
PLB_DESCRIPTION==הערה
***************************************
PRC_NUMBER==מס' מחירון/הסכם
PRC_VER==גירסה
PRC_DATE==תאריך תוקף
PRC_ITEM==פריט
PRC_BRANCH==מפעל
PRC_BASE_CONT==הסכם בסיס
PRC_MIN_SELL_QNT==כמות מינימום
PRC_PAYMENT_TERMS==תנאי תשלום
PRC_ITEM_PRICE==מחיר פריט
PRC_ITEM_DISCOUNT_TYPE==סוג הנחה לפריט
PRC_ITEM_DISCOUNT==הנחה לפריט
PRC_QNT_FOR_DISCOUNT==כמות עבורה קיימת הנחה נוספת
PRC_QNT_DISCOUNT_TYPE==סוג הנחת כמות
PRC_QNT_DISC_PRICE==ערך הנחת כמות
PRC_EXTRA_BASE==*
PRC_EXTRA_COST==*
PRC_EXT_DISCOUNT_TYPE==*
PRC_EXT_DISCOUNT==*
PRC_QNT1_FOR_DISCOUNT==*
PRC_QNT1_DISCOUNT_TYPE==*
PRC_QNT1_DISC_PRICE==*
PRC_QNT_DISC_PROGRESIVE==*
PRC_INDEX==מדד
PRC_INDEX_PERCENT==אחוז מהמדד
***************************************
QBF_TYPE==*
QBF_OBJ_NO==*
QBF_NO==*
QBF_DESCRIPTION==*
QBF_REP_NAME==*
QBF_RES_GROUP==*
QBF_BY_FILTER==*
***************************************
QFF_TYPE==*
QFF_OBJ_NO==*
QFF_NO==*
QFF_FIELD_NO==*
QFF_FIELD_NAME==*
QFF_FIELD_LABEL==*
QFF_OP1==*
QFF_OP2==*
QFF_DEF_MIN==*
QFF_DEF_MAX==*
QFF_LOGICAL_OP==*
QFF_FIELDTYPE==*
QFF_GET_RNG==*
QFF_OR_AND==*
***************************************
QFS_TYPE==*
QFS_OBJ_NO==*
QFS_NO==*
QFS_SORT_ORDER==*
QFS_FIELD_NAME==*
QFS_FIELD_LABEL==*
***************************************
QT_ID==מס' הצעה
QT_TYPE==סוג
QT_BRANCH==מפעל
QT_CUST_CODE==קוד לקוח
QT_CUST_NAME==שם לקוח
QT_SITE_CODE==קוד אתר
QT_SITE_NAME==שם אתר
QT_SITE_ADDRESS==כתובת אתר
QT_MAIL_ADDRESS==כתובת דואר
QT_MAIL_FAX==פקס
QT_EMAIL==דוא"ל
QT_PHONE_1==טלפון
QT_PHONE_2==טלפון נוסף
QT_CONTACT_PERSON==איש קשר
QT_SALESMAN==סוכן
QT_DATE==תאריך
QT_START_DATE==תקופה מ
QT_END_DATE==תקופה עד
QT_VALID_UNTIL==תוקף עד
QT_STATUS==סטאטוס
QT_FORWARD_ID==*
QT_CONTRACT_NUMBER==מס' הסכם
QT_ENTERED_DATETIME==תאריך הקמה
QT_ENTERED_BY==הוקם ע"י
QT_INDEX_TYPE==סוג מדד
QT_INDEX_PERCENT==אחוז מדד
QT_AUTO_INDEX==מדד אוטומטי
QT_PROJECT_NUM==קוד פרוייקט
QT_PROJECT_DESC==תיאור פרוייקט
QT_PRICE_INCLUDE_TAX==המחיר כולל מע"מ
***************************************
QTC_ID==מס' הצעה
QTC_CUST_NUM==מס' לקוח
QTC_CUST_CODE==קוד לקוח
QTC_CUST_NAME==שם לקוח
QTC_MAIL_CSTATE==מדינה
QTC_MAIL_CITY_CODE==קוד עיר
QTC_MAIL_CITY_NAME==שם עיר
QTC_MAIL_ADDRESS==כתובת
QTC_MAIL_ZIP==מיקוד
QTC_CUST_ACTIVE==לקוח פעיל
QTC_CONTACT_PERSON_CODE==קוד איש קשר
QTC_CONTACT_PERSON==איש קשר
QTC_PHONE_1==טלפון
QTC_PHONE_2==טל. נוסף
QTC_FAX==פקס
QTC_EMAIL==דוא"ל
***************************************
QTL_ID==מס' הצעה
QTL_BRANCH==מפעל
QTL_ITEM_CODE==פריט
QTL_REDUCTION_TYPE==סוג הפחתה
QTL_ITEM_PRICE==מחיר לפריט
QTL_REDUCTION==הפחתה
QTL_BASE_CONTRACT==סהכם בסיס
QTL_PAY_TERMS==תנאי תשלום
QTL_LEVEL1==רמה 1
QTL_ITEM_PRICE_1==מחיר פריט 1
QTL_REDUCTION_TYPE_1==סוג הפחתה 1
QTL_LEVEL2==רמה 2
QTL_REDUCTION_TYPE_2==סוג הפחתה 2
QTL_ITEM_PRICE_2==מחיר פריט 2
QTL_REDUCTION_2==הפחתה 2
***************************************
QTR_QT_ID==מס' הצעה
QTR_TR_TYPE==סוג
QTR_TR_TYPE_DESC==תיאור סוג
QTR_TR_INPUT_TYPE==סוג ערך
QTR_TR_SELECT_TBL==טבלת בחירה
QTR_REMARK==הערה
QTR_VALUE==ערך
QTR_STR_VALUE==ערך טקסטואלי
***************************************
RM_CODE==קוד
RM_GROUP==קבוצה
RM_DESCRIPTION==תיאור
RM_DESCRIPTION_ENG==*
RM_ENTRY_UNIT==*
RM_STOCK_UNIT==*
RM_USAGE_UNIT==*
RM_MIX_UNIT==*
RM_ENTRY_FACTOR_M==*
RM_ENTRY_FACTOR_D==*
RM_USAGE_FACTOR_M==*
RM_USAGE_FACTOR_D==*
RM_IN_SILO==*
RM_MAX_ENTRY==*
RM_IS_WEIGHED==*
RM_EXIT_WEIGH==*
RM_MODIF_GRP==*
RM_RELATIVE_GRP==*
RM_RELATIVE_MAT_GRP==*
RM_RELATIVE_M==*
RM_RELATIVE_D==*
RM_ITEM_CODE==*
RM_REPLACE==*
***************************************
RTR_SUPP_CODE==קוד ספק
RTR_SUPP_PLANT_CODE==קוד מפעל ספק
RTR_RAW_MAT_CODE==קוד חומר גלם
RTR_DATE==תאריך
RTR_REGISTRATION_DATE==תאריך רישום
RTR_PASS_0==נפה 0.075
RTR_PASS_1==נפה 0.15
RTR_PASS_2==נפה 0.3
RTR_PASS_3==נפה 0.6
RTR_PASS_4==נפה 1.18
RTR_PASS_5==נפה 2.35
RTR_PASS_6==נפה 4.75
RTR_PASS_7==נפה 9.5
RTR_PASS_8==נפה 14
RTR_PASS_9==נפה 19
RTR_PASS_10==נפה 10
RTR_PASS_11==נפה 25
RTR_PASS_12==נפה 37.5
RTR_DENSITY==צפיפות
RTR_DESCRIPTION==תיאור
***************************************
RCTL_TYPE==סוג
RCTL_BRANCH_NO==סניף
RCTL_NO==מספר
RCTL_LINE_NO==מס' שורה
RCTL_PAYMENT_TYPE==סוג תשלום
RCTL_SEC_PAYMENT_TYPE==בנק-סניף
RCTL_MAIN_NUMBER==חש. בנק/כ. אשראי
RCTL_SEC_NUMBER==מס' צ'ק/אישור אשראי
RCTL_CURR==מטבע
RCTL_AMOUNT==סכום
RCTL_DUE_DATE==תאריך מועד
RCTL_ACTUAL_DATE==תאריך בפועל
RCTL_STATUS==סטאטוס
RCTL_DATE==תאריך
RCTL_BR_CONNECTION==סניף נגדית
RCTL_NO_CONNECTION==מס' נגדית
RCTL_LINE_CONNECTION==מס' שורה נגדית
RCTL_RCV_BRANCH==סניף בו התקבלה
RCTL_COLLECTED==*
***************************************
RCT_TYPE==סוג
RCT_BRANCH_NO==מס' מפעל
RCT_NO==מספר
RCT_DATE==תאריך
RCT_CUS_WALKIN==לקוח מזדמן
RCT_WALKIN_BRANCH==מפעל ל. מזדמן
RCT_ACCOUNT_NO==מס' חשבון
RCT_REFERENCE_TYPE_1==*
RCT_REFERENCE_BRANCH_1==*
RCT_REFERENCE_NO_1==*
RCT_CURR_CODE==קוד מטבע
RCT_AMOUNT==סכום
RCT_COVERED==מכוסה
RCT_STATUS==סטאטוס
RCT_ACC_TRAN==פקודת יומן
RCT_EMPLOYEE==עובד
***************************************
REP_TYPE==*
REP_OBJ_NO==*
REP_NO==*
REP_DESC==*
REP_NAME==*
REP_EXCEL_FNAME==*
REP_START_ROW==*
REP_START_COL==*
REP_RES_GROUP==*
***************************************
RDF_TEST_ID==*
RDF_FLD_ID==*
RDF_FLD_DESC==*
RDF_RESULT_TYPE==*
RDF_FLD_TYPE==*
RDF_EXCEL_POS==*
***************************************
SMP_ORDER_SOURCE==*
SMP_ORDER_NUMBER==*
SMP_NUMBER==*
SMP_VER==*
SMP_CREATED_ON==*
SMP_EMPLOYEE==*
SMP_DATETIME==*
SMP_ENTRY_DATETIME==*
SMP_INT_REF_BRANCH==*
SMP_INT_REF_NUMBER==*
SMP_EXT_REF==*
SMP_TYPE==*
SMP_STATUS==*
SMP_MFG_PLANT==*
SMP_MFG_PROD_UNIT==*
SMP_ITEM_CODE==*
SMP_CUSTOMER==*
SMP_WALKIN_CUST==*
SMP_SITE==*
SMP_EXT_SITE_CODE==*
SMP_MAN_ID==*
SMP_TRUCK_CODE==*
SMP_TRUCK_NO==*
SMP_BATCH_NUMBER==*
SMP_LOT_NUMBER==*
***************************************
SMM_NUMBER==מדגם
SMM_TEST_ID==קוד בדיקה
SMM_SUB_SAMPLE==*
SMM_MSR_FLD_ID==*
SMM_MEASUREMENT_TYPE==*
SMM_DATETIME==תאריך בדיקה
SMM_ENTRY_DATETIME==הכנסת בדיקה
SMM_EMPLOYEE==עובד
SMM_RESULT==ממוצת בדיקה
SMM_RESULT_1==תוצאה 1
SMM_RESULT_2==תוצאה 2
SMM_RESULT_3==תוצאה 3
SMM_RESULT_4==תוצאה 4
***************************************
SMR_NUMBER==מדגם
SMR_TEST_ID==קוד בדיקה
SMR_RESULT_ID==*
SMR_RESULT_TYPE==*
SMR_DATETIME==תאריך מדגם
SMR_ENTRY_DATETIME==תאריך הכנסה
SMR_EMPLOYEE==עובד
SMR_RESULT==תוצאה
SMR_FAIL==כשל
SMR_OPTIMUM==אופטימלי
***************************************
SDAT_DISPATCHER==*
SDAT_DATETIME==תאריך
SDAT_TYPE==סוג
SDAT_CODE==קוד
SDAT_ITEM==פריט
SDAT_QNT==כמות
SDAT_AMMOUNT==סכום
***************************************
SDA_PLANT==מפעל
SDA_NUMBER==מספר
SDA_TYPE==סוג
SDA_CODE==קוד
SDA_ITEM==פריט
SDA_QNT==כמות
SDA_AMMOUNT==מחיר
SDA_EXPLAIN==הסבר
SDA_AMMOUNT_BASE==מחיר בסיס
SDA_CALC_QNT==כמות מחושבת
***************************************
SBM_PLANT==מפעל
SBM_SHD_NUMBER==תעודה
SBM_DATETIME==תאריך
SBM_BATCH_UNIT==תחנה
SBM_BATCH_ID==בקר
SBM_SILO==סילו
SBM_ERROR_CODE==שגיאה
***************************************
SDD_PLANT==מפעל
SDD_NUMBER==מספר
SDD_DRIVER_NAME==שם
***************************************
SDE_PLANT==מפעל
SDE_NUMBER==תעודה
SDE_CODE==קוד הסבר
SDE_DATETIME==תאריך
SDE_EXPLAIN==הסבר
***************************************
SDF_TEST_ID==קוד בדיקה
SDF_PLANT==מפעל
SDF_BATCH_UNIT==עמדת העמסה
SDF_RESULT_ID==קוד תוצאה
SDF_VER==גרסה
SDF_ITEM_CODE==פריט
SDF_SPEC_CODE==מפרט
SDF_DESC==תיאור
SDF_OPTIMUM==אופטימלי
SDF_RANGE_MIN_1==*
SDF_RANGE_MAX_1==*
SDF_RANGE_MIN_2==*
SDF_RANGE_MAX_2==*
SDF_RANGE_MIN_3==*
SDF_RANGE_MAX_3==*
***************************************
SDQ_PLANT==מפעל
SDQ_NUMBER==מס' ת.מ.
SDQ_RAW_MAT==חומר גלם
SDQ_SILO_CODE==סילו
SDQ_BASE_QNT==כמות מתוכננת
SDQ_REQ_QNT==נשלח להעמסה
SDQ_REAL_QNT==כמות בפועל
SDQ_HUM_PER==*
SDQ_SUPP==*
SDQ_SUPP_PLANT==*
***************************************
SDR_PLANT==מפעל
SDR_NUMBER==מס' תעודה
SDR_DATETIME==תאריך
SDR_REMARK==הערה לתעודה
***************************************
SDT_DISPATCHER==*
SDT_DATE==תאריך
SDT_REQ_PLANT==מפעל ביצוע ההזמנה
SDT_REQ_BATCH_TERMINAL==*
SDT_REQ_DATE==תאריך התעודה
SDT_WALKIN_CUST_BR==לקוח מזדמן
SDT_CUST_CODE==קוד לקוח
SDT_CONTRACT==הסכם
SDT_SITE==אתר
SDT_ORDER_PLANT==מפעל הזמנה
SDT_ORDER_NO==מס' הזמנה
SDT_ITEM==פריט
SDT_QNT==כמות
SDT_EXTRA_FACTOR==*
SDT_START_PROD==תחילת יצור
SDT_END_PROD==סיום יצור
SDT_TRUCK_NO==מס' משאית
SDT_DRIVER_CODE==קוד נהג
SDT_DRIVER_NAME==שם נהג
SDT_TRANSPORTER==מוביל
SDT_TARA_WGT==*
SDT_TOTAL_WGT==*
SDT_DISP_EMP_CODE==*
SDT_BATCHER==עובד יצור
SDT_STATUS==סטאטוס
SDT_TRANSPORT==מוביל
SDT_BATCH_BOOK==ספר אב
SDT_EXTERNAL_SUPP==ספק חיצוני
SDT_RET_SHD_PLANT==*
SDT_RET_SHD_NO==*
SDT_RET_QNT==*
SDT_ADD_WATER_ON_SITE==*
SDT_SHD_CREATED==*
SDT_SHD_PLANT==מפעל
SDT_SHD_NUM==מס' תעודה
SDT_DEST_NUM==*
SDT_ORDER_SUPP_QNT==*
SDT_ITEM_PROD==*
SDT_QNT_PROD==*
SDT_TRIM_WATER==*
SDT_PROD_TRIM_WATER_RATIO==*
SDT_TRUCK_ID==*
SDT_RET_PLANT_NUM==*
SDT_ELEMENT==*
SDT_PROD_UNIT==*
SDT_REMARK==*
SDT_SCHDLD_LEAVE_PLANT==*
SDT_SCHDLD_ON_SITE==*
SDT_SCHDLD_START_POUR==*
SDT_SCHDLD_END_POUR==*
SDT_SCHDLD_LEAVE_SITE==*
SDT_SCHDLD_RETURN==*
SDT_PHYSICAL_NUM==*
***************************************
SHD_PLANT==מפעל
SHD_NUMBER==מס' ת.מ.
SHD_DATE==תאריך
SHD_WALKIN_CUST_BR==לקוח מזדמן
SHD_CUST_CODE==קוד לקוח
SHD_CONTRACT==הסכם
SHD_SITE==אתר
SHD_ORDER_PLANT==מפ' הזמנה
SHD_ORDER_NO==מס' הזמנה
SHD_ITEM==פריט
SHD_QNT==כמות
SHD_EXTRA_FACTOR==תנאי תשלום
SHD_REQ_TIME==תאריך הפקה
SHD_START_PROD==תחילת יצור
SHD_END_PROD==סיום יצור
SHD_ARRIVE==הגעה לאתר
SHD_START_PLACING==תחילת פריקה
SHD_LEAVE_SITE==עזיבת אתר
SHD_RET_TO_PLANT==חזרה במפעל
SHD_TRUCK_NO==מס' משאית
SHD_DRIVER_CODE==קוד נהג
SHD_TRANSPORTER==מוביל
SHD_TARA_WGT==משקל טרה
SHD_TOTAL_WGT==סה"כ משקל
SHD_DISPATCHER==סדרן
SHD_DISP_EMP_CODE==*
SHD_BATCHER==מטעין
SHD_PROD_UNIT==תחנת יצור
SHD_STATUS==סטאטוס
SHD_INVOICE_BRANCH==סניף חשבונית
SHD_INVOICE_NO==מס' חשבונית
SHD_TRANSPORT==מוביל
SHD_CUST_DIST==טווח ללקוח
SHD_PARTIAL_TRAN_CUST==הובלה חלקית ללקוח
SHD_PARTIAL_TRAN_TRNS==הובלה חלקית למוביל
SHD_TRAN_DIST==טווח לנהג
SHD_CUST_WAIT_TIME==זמן המתנה לקוח
SHD_TRAN_WAIT_TIME==זמן המתנה מוביל
SHD_BATCH_BOOK==ספר אב
SHD_EXTERNAL_SUPP==ספק חיצוני
SHD_RET_SHD_PLANT==מפעל בטון חוזר/קנוי
SHD_RET_SHD_NO==ת.מ. בטון חוזר/קנוי
SHD_RET_QNT==כמות בטון חוזר
SHD_ADD_WATER_ON_SITE==הוספת מים באתר
SHD_CHANGED_DEST==*
SHD_CANCEL_REF==ת.מ. שבוטלה
SHD_FIXED_PRICE==מחיר קבוע
SHD_ITEM_PRICE==סה"כ מחיר פריט
SHD_EXTRA_PRICE==מחיר הובלה חלקית
SHD_TRANS_PRICE==מחיר הובלה
SHD_WAIT_PRICE==מחיר המתנה
SHD_ADDITIONALS_PRICE==מחיר תוספות
SHD_FIXED_TRANS_COST==עלות הובלה קבוע
SHD_RAW_MAT_COST==עלות חומרי גלם
SHD_TRANS_COST==עלות הובלה
SHD_WAIT_COST==עלות המתנה
SHD_ADDITIONALS_COST==עלות תוספות
SHD_RET_PLANT_NUM==מפעל בטון חוזר
SHD_ELEMENT==אלמנט
SHD_DEST_NUM==*
SHD_ACTUAL_DIST==*
SHD_QNT_PROD==*
SHD_ITEM_PRICE_BASE==מחיר פריט ליחידה
SHD_EXTRA_PRICE_BASE==*
SHD_TRANS_PRICE_BASE==*
SHD_WAIT_PRICE_BASE==*
SHD_ITEM_PROD==*
SHD_LOAD_NUM==*
SHD_ORDER_SUPP_QNT==*
SHD_TOTAL_QTY_SUPP==*
SHD_PHIS_PLANT==*
SHD_TRIM_WATER==*
SHD_WATER_ADDED_ON_SITE==*
SHD_PROD_TRIM_WATER==*
SHD_LEAVE_PLANT==*
SHD_END_POURING==*
SHD_EXPCTD_LEAVE_PLANT==*
SHD_EXPCTD_ON_SITE==*
SHD_EXPCTD_START_POUR==*
SHD_EXPCTD_END_POUR==*
SHD_EXPCTD_LEAVE_SITE==*
SHD_EXPCTD_RETURN==*
SHD_SCHDLD_LEAVE_PLANT==*
SHD_SCHDLD_ON_SITE==*
SHD_SCHDLD_START_POUR==*
SHD_SCHDLD_END_POUR==*
SHD_SCHDLD_LEAVE_SITE==*
SHD_SCHDLD_RETURN==*
SHD_ARRIVE_LOC_NS==*
SHD_ARRIVE_LOC_EW==*
SHD_START_POUR_LOC_NS==*
SHD_START_POUR_LOC_EW==*
SHD_END_POUR_LOC_NS==*
SHD_END_POUR_LOC_EW==*
SHD_LEAVE_SITE_LOC_NS==*
SHD_LEAVE_SITE_LOC_EW==*
SHD_PHYSICAL_NUM==*
SHD_CALC_PRICE==*
***************************************
SITE_ACC_BRANCH==מס' מפעל
SITE_ACCOUNT_NO==מס' לקוח
SITE_CONTRACT==הסכם
SITE_NUMBER==מס' אתר
SITE_DESCRIPTION==שם אתר
SITE_ADDRESS==כתובת
SITE_CITY_CODE==קוד עיר
SITE_CITY_NAME==שם עיר
SITE_ZIP==מיקוד
SITE_POB==ת. דואר
SITE_PHONE1==טלפון
SITE_PHONE2==טלפון נוסף
SITE_FAX==פקס
SITE_ZONE==איזור
SITE_VAT_CODE==*
SITE_TYPE==סוג אתר
SITE_STATUS==סטאטוס
SITE_DEFAULT_DIST_CUST==*
SITE_DEFAULT_DIST_CARR==*
SITE_DEFAULT_TRIP_TIME==*
SITE_LOCATION_CODE==*
SITE_GPS_N==*
SITE_GPS_W==*
SITE_CREATION_DATE==תאריך יצירה
SITE_LAST_MODIF_DATE==תאריך עדכון אחרון
SITE_MIRROR==אתר בסיס
SITE_CSTATE_CODE==*
SITE_ALLOWS_DESTINATIONS==*
SITE_SPLIT_TRIP_TIME_CALC==*
SITE_MAX_LOAD_SIZE==*
SITE_XMT_STATUS==סטאטוס אתר
SITE_OTHER_CODE==מספר המחסן
SITE_OTHER_DESC==מספר האיתור
***************************************
SID_CUST_BRANCH==*
SID_CUST==לקוח
SID_SITE_NUM==מס' אתר
SID_PLANT_NUM==מס' מפעל
SID_DIST_CUST==טווח ללקוח
SID_DIST_CARRIER==טווח למוביל
SID_TRIP_TIME==זמן נסיעה
***************************************
SMO_SOURCE==מכון
SMO_NUMBER==מספר הזמנה
SMO_INT_REF_BRANCH==*
SMO_INT_REF_NUMBER==*
SMO_EXT_REF==מספר במכון
SMO_TYPE==סוג
SMO_DATETIME==תאריך
SMO_STATUS==סטאטוס
SMO_CUSTOMER==לקוח
SMO_WALKIN_CUST==לקוח מזדמן
SMO_SITE==אתר
SMO_EXT_SITE_CODE==*
SMO_ITEM_CODE==פריט
SMO_ENTRY_DATETIME==תאריך הכנסה
SMO_FAIL_COVERED_SRC==*
SMO_FAIL_COVERED_NUMBER==*
SMO_INV_BRANCH==*
SMO_INV_NUMBER==*
SMO_EXT_INV_NUMBER==*
***************************************
SMOR_SOURCE==מכון
SMOR_NUMBER==מספר
SMOR_TYPE==סוג
SMOR_ENTRY_DATETIME==תאריך הכנסה
SMOR_DATETIME==תאריך
SMOR_EMPLOYEE==עובד
SMOR_REMARK==הערה
***************************************
OBJECT_TYPE==סוג אובייקט
SORT_GROUP_CODE==*
SORT_GROUP_DESC==*
SORT_AUTO_ENTRY==*
TABLE_NO==*
***************************************
OBJECT_TYPE==סוג אובייקט
SORT_GROUP_CODE==*
OBJECT_BRANCH==*
OBJECT_NO==מס' אובייקט
RELATION_VALUE==*
***************************************
SA_ACC_TYPE==*
SA_BRANCH==*
SA_ACC_DEB==*
SA_ACC_CRE==*
***************************************
STTR_TYPE==סוג
STTR_PLANT_NO==מפעל הקמת תנועה
STTR_TRANSACTION_NO==מס תנועה
STTR_LINE_NO==*
STTR_RCV_PLANT==מפעל תנועה
STTR_RAW_MAT_CODE==חומר גלם
STTR_SILO_NO==סילו
STTR_DATETIME==תאריך
STTR_DATETIME_FROM==*
STTR_QNT==כמות
***************************************
USER_NO==קוד משתמש
LINE_NO==מס' רשומה
***************************************
SPD_DOCKET_TYPE==סוג תעודה
SPD_BRANCH_NO==סניף כניסה
SPD_DOCKET_NO==מס' תעודה
SPD_INTERNAL==פנימי
SPD_DATETIME==תאריך
SPD_ACCOUNT==ספק
SPD_SITE==מפעל ספק
SPD_RAW_MAT_CODE==סוג חומר
SPD_CONTRACT_NO==הסכם
SPD_PLANT==מפעל
SPD_TRUCK_NO==משאית
SPD_TRAILER_NO==נגרר
SPD_TRANSPORTER==מוביל
SPD_SUPP_DOCK_NO==תעודת ספק
SPD_SUPP_TRAN_DOCK_NO==תעודת מוביל
SPD_COST==עלות
SPD_TRAN_COST==עלות הובלה
SPD_CREATED_ON==הוקם ע"י
SPD_STATUS==סטאטוס
SPD_RM_QNT==כמות
SPD_TARE_WGH==משקל טרה
SPD_TOTAL_WGH==סה"כ משקל
SPD_INV_BRANCH==סניף חשבונית
SPD_INV_NUMBER==מס' חשבונית
***************************************
SPDL_BRANCH==מפעל
SPDL_DOCKET_NO==מס' תעודה
SPDL_LINE_NO==מס' שורה
SPDL_DATE_TIME==תאריך
SPDL_ITEM_CODE==פריט
SPDL_QNT==כמות
SPDL_COST==עלות
SPDL_TRAN_COST==עלות הובלה
SPDL_INV_BRANCH==סניף חשבונית
SPDL_INV_NUMBER==מס' חשבונית
***************************************
SUPPLIER_CUSTOMER_CODE==קוד
SUPPLIER==ספק
INTERNAL_EXTERNAL==פנימי
MAIN_CUSTOMER_CODE==קוד לקוח מרכז
MAIN_SUPPLIER_CODE==קוד ספק מרכז
ACCOUNTING_CODE==מס' בהנה"ח
ID_PC==עוסק מורשה
DEBIT_DELAYED_CHEQUE==צ'קים דחויים
OPENING_BALANCE_DATE==תאריך יתרת פתיחה
DEBIT_SHIPING_DOCUMENTS==ת. מ. לפני חשבונית
DEBIT_INVOICE_RECEIPT==יתרה
CST_BONUS_PROGRAM==*
CST_BONUS_POINTS==*
CUSTOMER_CURRENCY==מטבע
MAXIMUM_CREDIT==גובה אשראי
CUSTOMERS_STATUS==סטאטוס לקוח
SUPPLIERS_STATUS==סטאטוס ספק
FACTORY_BRANCH_RELATION==מקור חשבונית
BASE_AGREEMENT_BRANCH==*
BA_CONTRACT_NUMBER==הסכם
CONTRY_CODE==קוד מדינה
VAT_TYPE_CODE==אחוז מע"מ
INVOICE_PRINTOUT_CODE==סוג תדפיס חשבונית
NUMBER_OF_COPIES==מספר עותקים
CUST_DISCOUNT_FROM_PL==*
CUSTOMER_TYPE==סוג לקוח
SUPPLIER_TYPE==סוג ספק
CREATION_DATE==תאריך הקמה
LAST_MODIFICATION_DATE==תאריך עדכון אחרון
CST_BREAK_ITEM==שבירת חשבונית
CST_PAYMENT_MODE==אופן תשלום
CST_SORT_1==*
CST_SORT_2==ביטחונות
CST_SORT_3==*
CST_SORT_4==עיר
CST_COLLECTOR==גובה
CST_CITY==עיר
CST_FAX==פקס
CST_POB==ת.ד
CST_PHONE==טלפון
CST_CONTACT_PERSON==איש קשר
CST_ZIP==מיקוד
CST_BANK==בנק
CST_BANK_BRANCH==סניף בנק
CST_BANK_ACCOUNT_NO==מס' חשבון
CST_INVOICE_DELIVERY_TYPE==אופן משלוח חשבונית
CST_STREET_NO==כתובת
FACTORY_BRANCH_RELATION_2==שייך למפעל נוסף
CST_PHONE_2==טל. נוסף
DEBIT_OPENING_BALANCE==יתרת פתיחה
DEBIT_DUE_BALANCE==יתרת חוב לגביה
CST_PAYMENT_TERM==תנאי תשלום
CST_AGENT==סוכן
CST_REMARK==הערה ללקוח
CST_XMT_STATUS==סטאטוס שידור
***************************************
CSA_SUP_CUS_NO==*
CSA_COMPANY==*
CSA_ITEM_CODE==*
CSA_DEB_ACCOUNT==*
CSA_CRE_ACCOUNT==*
CSA_BALANCE==*
CSA_BALANCE_DATE==*
***************************************
TARA_TRUCK==*
TARA_PLANT==*
TARA_SCALE==*
TARA_REQ_DATE==*
TARA_DATE==*
TARA_WGHT==*
TARA_DONE==*
***************************************
TBP_TBL_NO==*
TBP_PARAM_NO==*
TBP_LABEL==*
TBP_PARAM_TYPE==*
TBP_SELECT_TBL_NUM==*
TBP_SEL_SQL==*
TBP_LOC_SQL==*
TBP_SEL_CODE_FNAME==*
TBP_SEL_DESC_FNAME==*
TBP_SEL_CODE_WIDTH==*
TBP_SEL_DESC_WIDTH==*
TBP_SEL_TOP==*
TBP_SEL_HEIGHT==*
TBP_SEL_WIDTH==*
TBP_SEL_LEFT==*
TBP_SEL_ORDER_BY==*
TBP_DEFAULT==*
TBP_SEL_STR_CODE==*
***************************************
TCA_PLANT==*
TCA_START_DATE==*
TCA_BU_NUMBER==*
TCA_ADDITION_TYPE==*
TCA_QNT==*
TCA_EXPLAIN==*
***************************************
MCT_PLANT_NO==מס' מפעל
MCT_DATETIME==תאריך
MCT_BOOK_NO==מס' ספר אב
MCT_CUST_CODE==קוד לקוח
MCT_ITEM_CODE==קוד פריט
MCT_VER_NO==מס' גירסה
MCT_RM_CODE==קוד חומר
MCT_BASE_QNT==כמות בסיס
MCT_MODIF_QNT==כמות שינוי
MCT_MODIF_TYPE==סוג שינוי
MCT_MODIF_PERCENT==אחוז שינוי
MCT_MODIF_MASK==*
MCT_QNT==כמות
MCT_RET_QNT==*
MCT_MAX_DIFF_UP==סטיה מקס. למעלה
MCT_MAX_DIFF_DOWN==סטיה מקס. למטה
MCT_REAL_QNT==*
MCT_RELATED_RM==*
MCT_FACTOR_MULT==*
MCT_FACTOR_DIV==*
MCT_HUM_PER==*
MCT_DENSITY==צפיפות
MCT_PASS_0==עובר 0
MCT_PASS_1==עובר 1
MCT_PASS_2==עובר 2
MCT_PASS_3==עובר 3
MCT_PASS_4==עובר 4
MCT_PASS_5==עובר 5
MCT_PASS_6==עובר 6
MCT_PASS_7==עובר 7
MCT_PASS_8==עובר 8
MCT_PASS_9==עובר 9
MCT_PASS_10==עובר 10
MCT_PASS_11==עובר 11
MCT_PASS_12==עובר 12
MCT_SUPP==ספק
MCT_SUPP_PLANT==מפעל ספק
MCT_UNIT_PRICE==מחיר יחידה
MCT_COST==עלות
***************************************
TDF_ID==*
TDF_TYPE==*
TDF_DESC==*
TDF_OWNER_GRP==*
TDF_BMP_RESULTS==*
TDF_RESULTS_TBL==*
TDF_BMP_MSR==*
TDF_MSR_TBL==*
TDF_EXCEL_FNAME==*
TDF_DELAY==*
TDF_DEF_STATUS==*
TDF_MSR_STATUS==*
TDF_DONE_STATUS==*
***************************************
TID_TEST_ID==*
TID_ITEM_CODE==*
TID_DEF==*
***************************************
TRC_NUMBER==*
TRC_DESCRIPTION==*
TRC_DATE==*
TRC_LAST_MODIF_DATE==*
TRC_ACCOUNT_NO==*
TRC_DIST_1==*
TRC_DIST_2==*
TRC_DIST_3==*
TRC_CALC_MODE==*
TRC_WAIT_TIME_OVERRIDE==*
TRC_ACTIVE_VER==*
TRC_ACTIVE_DATE==*
TRC_INDEX_TYPE==*
TRC_INDEX_PERCENT==*
***************************************
TRCL_NUMBER==*
TRCL_PLANT==*
TRCL_ITEM_GRP==*
TRCL_TRUCK_TYPE==*
TRCL_VER==*
TRCL_DATE==*
TRCL_BASE_COST_F==*
TRCL_BASE_COST_D==*
TRCL_BASE_COST_U==*
TRCL_RNG1_COST_F==*
TRCL_RNG1_COST_D==*
TRCL_RNG1_COST_U==*
TRCL_RNG2_COST_F==*
TRCL_RNG2_COST_D==*
TRCL_RNG2_COST_U==*
TRCL_RNG3_COST_F==*
TRCL_RNG3_COST_D==*
TRCL_RNG3_COST_U==*
TRCL_WAIT_BASE==*
TRCL_WAIT_UNIT==*
TRCL_WAIT_COST==*
TRCL_MIN_QNT==*
TRCL_PARTIAL_TRAN_COST==*
***************************************
TRCR_NUMBER==*
TRCR_PLANT==*
TRCR_ITEM_GRP==*
TRCR_TRUCK_TYPE==*
TRCR_VER==*
TRCR_RANGE==*
TRCR_FIXED_COST==*
TRCR_UNIT_COST==*
***************************************
TWP_DATE==תאריך
TWP_TRUCK_ID==קוד משאית
TWP_ZONE==איזור
TWP_SERIAL==*
TWP_SD_PLANT==.מקור ת.מ
TWP_SD_NUMBER==.מס' ת.מ
TWP_LAST_RETURN==חזרה אחרונה
TWP_START_DATETIME==זמן התחלה
TWP_END_DATETIME==זמן סיום
TWP_TRIPS==גיחות
TWP_DISTANCE==מרחק
TWP_DISPATCHER==סדרן
TWP_CHECKIN_PLANT==*
TWP_PLANT==מפעל
TWP_TRANSPORTER==מוביל
TWP_DRIVER_CODE==קוד נהג
TWP_DRIVER_NAME==שם נהג
TWP_SD_QTY==*
TWP_SD_ORDER_PLANT==*
TWP_SD_ORDER_NUMBER==*
TWP_ORDER_PLANT==מפעל הזמנה
TWP_ORDER_NUMBER==הזמנה
TWP_SCHDLD_START_DATETIME==*
TWP_SCHDLD_END_DATETIME==*
TWP_GSM_CODE==*
TWP_GPS_CODE==*
TWP_INFO==*
TWP_TOTAL_QTY==סיכום כמות
TWP_STATUS==סטאטוס
TWP_XMT_STATUS==*
TWP_OUT_OF_PLANT==*
TWP_NEXT_STATUS_TIME==*
**************************************
OBJECT_CODE==*
OBJECT_TYPE_9001==*
RECORD_TYPE==*
RECORD_ID==*
OBJECT_BRANCH==*
RECORD_DATA==*
***************************************
TRU_ID==קוד משאית
TRU_NO==מס' משאית
TRU_OWNER==בעלות
TRU_TYPE==סוג משאית
TRU_TARA_FREQ==חובת שקילת טרה בימים
TRU_TARA_PROBABILITY==אחוזי הסתברות לשקילת טרה
TRU_TARA_WEIGHT==משקל טרה
TRU_MAX_WEIGHT==משקל מקסימום
TRU_NET_QNT==נפח
TRU_TRANS_CONT==הסכם הובלה
TRU_STATUS==סטאטוס
TRU_DEF_ZONE==איזור
TRU_DRIVER_CODE==קוד נהג
TRU_DRIVER_NAME==שם נהג
TRU_BADGE_ID==*
TRU_GSM_CODE==קוד GSM
TRU_GPS_CODE==קוד GPS
TRU_REMARK==הערה
TRU_DEF_PLANT==מפעל תחילת יום
TRU_DEF_DISPATCHER==סדרן אחראי
***************************************
BRANCH_NO==מס' סניף
CUSTOMER_NO==מס' לקוח
COUNTRY_CODE==קוד מדינה
ID_PASSPORT==מס' ת. זהות
CUSTOMER_NAME==שם לקוח
CITY_CODE==קוד עיר
CITY_NAME==שם עיר
ADDRESS==כתובת
***************************************
WCR_BATCH_BOOK==ספר אב
WCR_ITEM_CODE==פריט
WCR_RATIO_MUL==*
WCR_RATIO_DIV==*
***************************************
WGHO_CODE==סדר הטענה
WGHO_RAW_MAT==חומר
WGHO_W_ORDER==סדר שקילה
WGHO_D_METHOD==שיטת פריקה
WGHO_PLANT==מפעל
WGHO_BATCH_UNIT==עמדת יצור
WGHO_SILO_NUM==סילו
***************************************
ZDST_ZONE_FROM==*
ZDST_ZONE_TO==*
ZDST_FACTOR==*
***************************************
ASCII_DEF_ID==*
DESCRIPTION==*
FILE_NAME==*
TABLE_NAME==*
TBL_DEF_NUMBER==*
DELETE_FILE_AFTER_INPUT==*
OS_OPER_BEFORE==*
OS_OPER_AFTER==*
DELIMITED==*
DELIMITER==*
END_OF_LINE==*
***************************************
ASCII_DEF_ID==*
FIELD_NO==*
DESCRIPTION==תיאור
FIELDNAME==*
LOCATION==מיקום
LEN==*
SERIAL_ASCII==*
PICTURE==תמונה
AFD_TYPE==*
BOOLEAN_TRUE==*
BOOLEAN_FALSE==*
SELECT_TABLE_NO==*
DATA_FIELD_NAME==*
LOCATION_DATA==*
LEN_DATA==*
ACCEPT_NOT_EXISTING==*
COUNTER_ID==*
AFD_INDEX==*
SELECT_TYPE==*
PARAM_LOCATION==*
PARAM_LEN==*
IS_HEX==*
HOUR_FROM==*
HOUR_LEN==*
MINUTE_FROM==*
MINUTE_LEN==*
DAY_FROM==*
DAY_LEN==*
MONTH_FROM==*
MONTH_LEN==*
YEAR_FROM==*
YEAR_LEN==*,
AFD_DEF==*
***************************************
ID==*
LASTUSERID==*
LASTGROUPID==*
LASTRIGHTID==*
***************************************
DB_ID==*
DB_DESCRIPTION==*
DB_DRIVER==*
DB_ACTIVE==*
DB_INI_FILE==*
DB_TRN_FILE==*
***************************************
GROUPID==קוד קבוצה
GROUPNAME==שם קבוצה
GROUPDESCRIPTION==תיאור קבוצה
***************************************
RIGHTID==קוד הרשאה
GROUPID==קוד קבוצה
***************************************
KINDID==*
SELECTMAXIMIZED==*
FULLMAXIMIZED==*
KINDDESCRIPTION==*
CODETOP==*
CODELEFT==*
CODEHEIGHT==*
CODEWIDTH==*
CODEFONT==*
CODECFONT==*
CODELABELTOP==*
CODELABELLEFT==*
CODELABELHEIGHT==*
CODELABELWIDTH==*
CODELABELFONT==*
CODECLABELFONT==*
DESCRIPTIONTOP==*
DESCRIPTIONLEFT==*
DESCRIPTIONHEIGHT==*
DESCRIPTIONWIDTH==*
DESCRIPTIONFONT==*
DESCRIPTIONCFONT==*
DESCLABELTOP==*
DESCLABELLEFT==*
DESCLABELHEIGHT==*
DESCLABELWIDTH==*
DESCRIPTIONLABELFONT==*
DESCRIPTIONCLABELFONT==*
CODEGREEDP==*
DESCRIPTIONGREEDP==*
CODEREPORTP==*
DESCRIPTIONREPORTP==*
HELPCONTEXT==*
FORMTOP==*
FORMLEFT==*
FORMWIDTH==*
FORMHEIGHT==*
FORMCOLOR==*
GRIDTOP==*
GRIDLEFT==*
GRIDWIDTH==*
GRIDHEIGHT==*
ADDDATAPANELTOP==*
ADDDATAPANELLEFT==*
ADDDATAPANELWIDTH==*
ADDDATAPANELHEIGHT==*
ADDDATAPANELCOLOR==*
SYSTEM_USER_A==*
CODEFIELDNAME==*
CODEHANDLING==*
SORTFIELDNAME==*
INDEXNAME==*
HEBREW_ENABLED==*
GRD_PANEL_HEIGHT==*
GRD_COLOR_FLD==*
GRD_COLOR_TBL==*
*****************************************
KINDID==*
FIELDID==*
SELECTFIELDNAME==*
FIELDNAME==*
SELECTFIELDDISPLAYLABEL==*
FIELDDISPLAYLABEL==*
FIELDTYPEID==*
FALSEVALUE==*
TRUEVALUE==*
SELECTID==*
OMDATA_FROM==*
OMDATA_SIZE==*
SELECTSIZE==*
PICTURE==*
DATATOP==*
DATALEFT==*
DATAWIDTH==*
DATAHEIGHT==*
DATAFONT==*
DATACFONT==*
LABELTOP==*
LABELLEFT==*
LABELHEIGHT==*
LABELWIDTH==*
LABELFONT==*
LABELCFONT==*
GRIDP==*
SELECTTOP==*
SELECTLEFT==*
SELECTHEIGHT==*
SELECTWIDTH==*
SELECTGRIDP==*
SELECTFONT==*
SELECTCFONT==*
SELECTREPORTP==*
SELECTLABELTOP==*
SELECTLABELLEFT==*
SELECTLABELHEIGHT==*
SELECTLABELWIDTH==*
SELECTLABELFONT==*
SELECTCLABELFONT==*
REPORTP==*
HELPCONTEXT==*
HELPHEADER==*
ENABLEHINT==*
HINT==*
COUNTER_TYPE==*
HEBREW_ENABLED==*
LOOKUPBYFIELD==*
LOOKUPRESULTBYFIELD==*
ENABLE_RIGHT==*
VISIBLE_RIGHT==*
LOOKUP_SQL_1==*
LOOKUP_SQL_2==*
LOOKUP_STR_CODE==*
BEHAVE==*
DEFAULT_VALUE==*
COLOR_FLD==*
COLOR_TBL==*
IS_KEY==*
***************************************
RIGHTID==הרשאות
RIGHTNAME==שם
RIGHTDESCRIPTION==תיאור
***************************************
TABLEID==מס' טבלה
TABLENAME==שם טבלה
OBJECTTYPE==סוג אובייקט
TABLETYPE==סוג טבלה
KINDID==*
INPUT_TYPE_ID_G==*
INPUT_TYPE_ID_D==*
SYSTEN_USER==*
DETAILS_DEF_TABLE_ID==*
TBL_SQL==*
TABLEDESCRIPTION==תיאור טבלה
OBJECT_BRANCH_FIELD==*
OBJECT_NUMBER_FIELD==*
LIVE_SQL==*
LANG_DIRECTION==*
TBD_DESIGN_GRP==*
TBD_RT_VIEW_GRP==*
TBD_RT_MODIFY_GRP==*
TBD_RT_ADD_GRP==*
TBD_RT_DELETE_GRP==*
***************************************
TYPEID==מס' סוג
TYPE==סוג
***************************************
USERID==מס' משתמש
LINE_NO==מס' שורה
TABLEID==מס' טבלה
CAN_MODIFY==יכולת לעדכן
CAN_ADD==יכולת להוסיף
CAN_DELETE==יכולת למחוק
***************************************
USERID==מס' משתמש
IDENTIFICATION==זיהוי
FNAME==שם משפחה
USERLNAME==שם פרטי
USERPASS==סיסמה
USERADDR==כתובת
USERPHONE==טלפון
USERMENUID==מס' תפריט
***************************************
USERID==קוד משתמש
GROUPID==קוד קבוצה
***************************************
RIGHTID==קוד הרשאה
USERID==קוד משתמש
***************************************
TABLEID==מס' טבלה
LINEID==מס' רשומה
DESCRIPTION==תיאור
DATA==נתונים
*************** END **********************************************
CALC_WALKIN_NAME==*
ITEM LIST PRICE==*
PRINT_MODE==אופן הדפסה
BASE_TABLE==טבלת בסיס
SEC_TABLE==טבלה נוספת
REMARK_TABLE==טבלת הערות
COUNT==*
CUSTID==קוד לקוח
CUSTNAME==שם לקוח
PHONENUM==מס' טלפון
TABLE ID ALLREDY EXIST==מספר טבלה כבר בשימוש
CHANGES ARE NOT SAVED CONTINUE !==! שינוים לא נשמרו, המשיך
-TOTAL- ==סיכום
MALE_OR_FEMALE==זכר/נקבה
EXP TYPE==*
PAYMENT STATUS==סטאטוס תשלום
ACC==*
SPLIT DEBIT==פיצול חובה
SPLIT CREDIT==פיצול אשראי
REF ACCOUNT==*
RATE==שער
SEL SELECT==*
ROUND NUMBER==מספרים עגולים
SUPPLIER SITE==אתר ספק
REGISTRATION DATE==מועד הרשמה
TEST DATE==תאריך בדיקה
DENSITY==צפיפות
CHANGES WHERE NOT SAVED IN GRID AND DETAILE DESIGN! CONTINUE ?!==!? שינוים לא נשמרו בתכנון רשת ופריטים, להמשיך
MENU DESIGN==תכנון תפריט
COPY MENU==העתק תפריט
DELETE MENU==מחק תפריט
NEW MENU==תפריט חדש
SHOW==הצג
MANUAL DESIGN==תכנון ידני
FATHER GROUP==קבוצת אב
OP CODE==*
PIC DIR==מיקום תמונה
DELETE MENU WITH ALL SUB MENUS !==! מחיקת תפריט עם כל התת-תפריטים
ACTIVATE ORDER NO ==הזמנה פעילה אחרונה
DEFINE NEW SITE?!==!? להקים אתר חדש
SHIPING DOCKET NO ==מס' תעודת משלוח
ORIGINAL==מקור
INVOICE==חשבונית
SELECT RANGE==בחר טווח
DELETE REPORT DEFINITIONS ?!==!? למחוק הגדרות דו"ח
TABLE ID==קוד טבלה
PARAMS LIST==רשימת פרמטרים
FIELD NOT DEFINED PROPERLY==השדה לא מוגדר היטב
DELETE ==מחק
GENERAL DEFINITIONS==הגדרות כלליות
RIGHTS DEFINITIONS==הגדרת הרשאות
DESIGN GROUP ==תכנון קבוצה
VIEW GROUP ==הצגת קבוצה
DELETE GROUP ==מחיקת קבוצה
ADD GROUP ==הוספת קבוצה
MODIFY GROUP ==התאמת קבוצה
SHIPPING DOCKET VIEW==הצג ת. משלוח
NEW TABLE WAS ADDED SUCCESSFULLY ==! הוספת טבלה בוצע בהצלחה
OBJECT IS MISSING !==! אובייקט חסר
DELETE PARAM ==*
CUSTOMER DETAILS==פרטי לקוח
DESTINATION ==יעד
SHD_TIME==זמן תעודה
SHD_HOUR==שעת תעודה
SHD_MINUTE==דקות תעודה
SUPP_QNT==כמות אספקה
CAPTION==כותרת
BVR WGH==תוכנית שקילה
WEIGHT==שקילה
TARA==טרה
TRUCK NO ==מספר משאית
BATCH UNITS ==יחידות יצור
DUE DATE DEF TYPE==*
DUE DATE OFFSET==*
RCTL PAY STAT==*
DEPOSIT STATUS==סטאטוס הפקדה
ACCUMULATED==הצטבר
DLL NAME==*
AUTO-COMM :==*
INPUT SUB==*
SUBTABLE==*
INPUT MAIN==שדה עיקרי
INPUT SEC==שדה משני
INPUT DUE DATE==פתיחת תאריך פירעון
FIXED COST==עלות קבועה
OPTIONS==אפשרויות
UNIT COST==עלות ליחידה
AMMOUNT==*
ISSUE RECEIPT==הנפקת קבלה
SUM_QNT==חישוב כמות
SUM_PRICE==חישוב מחיר
CAN NOT DELETE LAST TAB !==! אין אפשרות למחוק טבלה אחרונה
PLANT NAME==שם מפעל
CUSTOMER DISTANCE==טווח ללקוח
CARRIER DISTANCE==טווח למוביל
TRIP TIME==זמן נסיעה
COVERED==מכוסה
DAYS==ימים
MONTHS==חודשים
CURRENT==שוטף
CITY  CODE==קוד עיר
COLOR==צבעים
SIZE==גודל
NO_OF_PLANT==מס' מפעל
BATCH FILE==קובץ יצור
PROGRAM LIST==רשימת תוכניות
NORMAL==רגיל
MAXIMIZE==מוגדל
MINIMIZE==מוקטן
EXECUTE WINDOWS PROGRAM==ביצוע תוכנית WINDOWS
EXECUTE BATCH OR EXEC TABLE==ביצוע טבלאות הפעלה
EXECUTE REPORT FROM TABLE==ביצוע דו"ח מטבלה
EXECUTE ANOTHER BATCH OPERATION==ביצוע פעולת אצווה נוספת
EXPORT ASCII==ASCII יצוא
IMPORT ASCII==ASCII יבוא
XML EXPORT==XML יצוא
XML IMPORT==XML יבוא
DEFINE BATCH OPERATIONS==הגדרת פעולות אצווה
DESIGN PARAMS==תכנון פרמטרים
BATCH OPERATIONS==פעולות אצווה
WINDOW SIZE==גודל החלון
BATCH PARAM==פרמטר אצווה
WINDOW SIZE ==גודל חלון
BATCH PARAM ==פרמטר אצווה
LINE NO ==מס' רשומה
LINE TYPE ==סוג רשומה
PROGRAM ==תוכנית
SELECT BATCH OPERATION ==בחר פעולת אצווה
SELECT IMP/EXP DEF ==בחירת הגדרת יבאו/יצאו
SELECT TABLE==בחירת טבלה
LINE NUMBER==מס' רשומה
OPERATION CODE==קוד פעולה
PROGRAM==תוכנית
MAXIMIZED==הגדלה
DATA INPUT DEFINITIONS==הגדרת הכנסת נתונים
OBJECT==אובייקט
TRAILERS==נגררים
DATA TYPE==סוג נתון
GRID CODE==*
GRID INPUT TYPE==*
DETAILES CODE==קוד פרטים
DETAILED INPUT TYPE ==*
SINGLE / MULTIPLE==*
GRID==רשת
DETAILED==מפורט
DETAILED INPUT NO==*
DETAILED INPUT TYPE==*
SORT GROUPS==מיון קבוצות
SORT GROUP CODE==מיון קוד קבוצה
SORT GROUP DESC==מיון תיאור קבוצה
TABLE LOOKUP==*
SORT_AUTO_ENTRY==*
PN_OBJECTS==*
ASCII MANAGMENT==ניהול קבצי ASCII
IMPORT FROM ASCII FILE TO TABLE==יבוא לטבלה מ-ASCII
EXPORT  FROM TABLE / QUERY TO ASCII FILE==יצוא מטבלה ל-ASCII
IMPORT FROM EXCEL==יצוא ל-EXCEL
ASCII FILES MANAGMENT==ניהול קבצי ASCII
PARAMETERS STRING==מחרוזת ערכים
FOR EXCEL EXPORT :==יבוא ל-EXCEL
OS OPER BEFORE = FIRST ROW==*
OS OPER AFTER = LAST ROW==*
END OF LINE  = ACTIVE COLOM==*
FILE NAME==שם קובץ
TABLE NAME==שם טבלה
DELIMITED==מוגבל
DELIMITER==*
OS OPERATION BEFORE==*
OS OPERATION AFTER==*
TBL_DEF NO==*
TBL_DEF NAME==*
DELETE FILE AFTER INPUT==מחק קובץ אחרי קליטה
E.O.L==*
FIELD NO==מספר שדה
FIELD NAME==שם שדה
LOCATION==מיקום
LEN==*
SERIAL_ASCII==*
SELECT NO==בחר מספר
SELECT NAME==בחר שם
DATA FIELD NAME==שם שדה נתונים
ACCEPT NOT EXISTING SELECT==*
LEN_DATA==*
LOCATION_DATA==*
TYPE ID==*
PICTURE==תמונה
BOOLEAN FALSE==*
BOOLEAN TRUE==*
COUNTER ID==מספר מונה
SELECT_TYPE==*
PARAM_LOCATION==*
PARAM_LEN==*
IS_HEX==*
AFD_INDEX==*
DAY_FROM==*
DAY_LEN==*
MONTH_FROM==*
MONTH_LEN==*
YEAR_FROM==*
YEAR_LEN==*
HOUR_FROM==*
HOUR_LEN==*
MINUTE_FROM==*
MINUTE_LEN==*
DO_BY_SQL==*
XML OPERATION==פעולות XML
IMPORT NO OVERWRITE==יבוא ללא דריסה
EXPORT==יצוא
IMPORT AND OVERWRITE==יבוא עם דריסה
PLEASE ENTER ACCOUNT DETAILS==נא לרשום פרטי חשבון
ACCOUNT NAME==שם חשבון
ACCOUNT NUMBER==מספר חשבון
INTERNAL==פנימי
NEW CONTRACT==הסכם חדש
CREATE THIS CONTRACT ?==? לבנות הסכם זה
MUST BE ENTERED==חייב להיות רשום
PLEASE ENTER SITE ZONE==נא לרשום איזור האתר
THIS SITE DOESN'T EXIST==! האתר אינו קיים
SITE DISTANCE==מרחק לאתר
PN_LIST==רשימה
DELETE THE RECORD ?!==!? למחוק את הרשומה
SHIP DOCK DATE  ==תאריך ת. משלוח
SHIP DOCK TIME ==שעת ת. משלוח
PN_TRANSPORTER_DOCKET==תעודת הובלה
ENTRY DATE ==תאריך כניסה
SUPPLIER ==ספק
SUPPLIER DOCKET ==תעודת ספק
TRUCK ==משאית
TRAILER  ==נגרר
TRANSPORTER ==מוביל
TRANSPORTER DOCKET ==תעודת מוביל
PN_BOTTOM_DET==*
RAW MAT==חומר גלם
PHISICAL SILOS==סילוסים פיזים
COST==עלות
TRAN COST==עלות הובלה
CANCEL ALL CURRENT CHANGES ?==? לבטל תהליך שינוי כולו
DESIGN BATCH TICKET==בניית ספר הפעלה
GRAPH==תרשים
DO MODIF==עדכן
MIXTURE GRADING==דירוג תערובת
SAVE NEW TICKET ?!==?! לשמור כרטיס חדש
DISCHARGE TYPE IS MISSING==! חסר סוג פריקה
SAVE CHANGES?==? לשמור שינוים
MAX DIFFERENCE UP IS MISSING==השינוי מקסימאלי כלפי מלה חסר
CANCEL ALL CURRENT CHANGES ?!==!? לבטל תהליך שינוים כולו
CREATE NEW VERSION ?!==!? ליצור גירסה חדשה
CHANGES ARE NOT SAVED !==! שינוים לא נשמרו
NO LINES IN TICKET==אין נתונים בכרטיס
INSERT MESSAGES==שליחת הודעות
MESSAGES==הודעות
TO ==אל
DATE ==תאריך
MESSAGE TYPE ==סוג הודעה
REMARK ==הערה
TIME ==שעה
SAVE CURRENT MESSAGE ?==? לשמור הודעה
SHIP DOCKET MANAGE==טיפול בתעודה
SUPP DOCK VIEW==הצג תעודת ספק
DOCKET==תעודה
BRANCH ==מפעל
SUPPLIER DOCKETS==תעודות ספק
MANUAL DOCKET==תעודה ידנית
&SUPP DOCK==תעודת ספק
CANCEL DOCKET==בטל תעודה
PRINT DOCUMENT==הדפס תעודה
SUPP &DOCK LINES==שורות תעודת ספק
DATE & TIME==תאריך ושעה
DELETE ITEM ?!==? למחוק פריט
ITEMS LIST==רשימת פריטים
ITEM SPEC==עקומת דירוג רצויה
BATCH BOOK NO==מס' ספר אב
SPEC CODE==קוד עקומה
SELECT SPEC==בחירת עקומה
GRADING==דירוג
USAGE IN PLANTS==שימוש במפעלים
DATE OF MODIF==תאריך עדכון
MODIFIED BY==מעודכן על-ידי
VIEW GRADING==הצג דירוג
CHANGES WHERE NOT SAVED IN DETAILE DESIGN! CONTINUE ?!==!? שינוים לא נשמרו בתכנון פרטים, להמשיך
ENTER BASE CONTRACT==! חסר הסכם בסיס
INCORRECT VALUES==! ערכים חדשים לא נכונים או חסרים
NOT AN ACTIVE BATCH BOOK ITEM==! פריט לא פעיל בספר אב
STATUS 11==*
STATUS 12==*
STATUS 13==*
PLATE NO==*
ITEM IS MISSING==! חסר פריט
RAW MA CODE==קוד חומר גלם
PHISICA SILO NUM==*
ADJUSTMENT METHOD==*
CREDIT_N==זכות
DEBIT_N==חובה
DEBIT==חובה
TRN_TYPE==סוג
TRN_BRANCH==מפעל
TRN_NUMBER==מספר
TRN_STATUS==סטאטוס
TRN_DATE==תאריך
TRN_UNCOVERED==לא מכוסה
TRN_DUE_DATE==תאריך פרעון
TRN_BALANCE==מצב כספי
TRANSACTION BALANCE==*
TRANSACTION BALANCE_B==*
FUNCTIONS==*
SAVE CONTRACT DETAILS ?!==!? לשמור פרטי הסכם
ITEM_GROUP==קבוצת פריט
ITEM_PRICE==מחיר פריט
TRANSPORT_PRICE==מחיר הובלה
WAIT_PRICE==מחיר המתנה
ADDITION_PRICE==מחיר תוספת
SHIP DOCK IS ALLREADY CLOSED==! תעודת משלוח כבר סגורה
BUILD INVOICE==בניית חשבונית
&BUILD ==בניה
ITEM ID==קוד פריט
DISCOUNT %==הנחה %
INSERT NEXT ITEM TO INVOICE==! הכנס פריט הבא לחשבונית
SAVE CHANGES TO INVOICE LINE==! שמור שינוים בשורת חשבונית
DELETE ITEM==מחק פריט
EXCHANGE RATE==שער חליפין
CLERK==פקיד
VAT==מע"מ
SUB TOTAL==סכום סה"כ
TAXED==יכלול מע"מ
UNTAXED==ללא מע"מ
ITEM DESCRIPTION==תיאור פריט
DISCOUNT AMOUNT==סכום הנחה
TOTAL PRICE==מחיר סופי
REAL_ITEM_DESCRIPTION==*
PLEASE FILL THE LINES==! נא למלא את השורות
CALC_FIX_PRICE==*
BU==*
QNT_SILO_1==*
QNT_SILO_2==*
QNT_SILO_3==*
QNT_SILO_4==*
QNT_SILO_5==*
QNT_SILO_6==*
QNT_SILO_7==*
QNT_SILO_8==*
QNT_SILO_9==*
QNT_SILO_10==*
QNT_SILO_11==*
QNT_SILO_12==*
FROM_PLANT==ממפעל
TO_PLANT==עד מפעל
FROM_CUST==מלקוח
TO_CUSTOMER==עד לקוח
FROM_DATE==מתאריך
TO_CUST==עד לקוח
USERS MANAGMENT==ניהול משתמשים
USERS==משתמשים
USERS LIST==רשימת משתמשים
USERID==קוד משתמש
USERFNAME==שם פרטי
USERLNAME==שם משפחה
FIRST NAME ==שם פרטי
LAST NAME ==שם משפחה
IDENTIFICATION ==*
ADDRESS ==כתובת
PHONE ==טלפון
PASSWORD ==סיסמה
USER MENU ==תפריט משתמש
USER GROUPS==קבוצות משתמשים
GROUPID==קוד קבוצה
GROUPNAME==שם קבוצה
GROUPDESCRIPTION==תיאור קבוצה
SELECT ALL==בחר הכל
RMOVE ALL==*
USER RIGHTS==הרשאות משתמש
RIGHTID==קוד הרשאה
RIGHTNAME==שם הרשאה
RIGHTDESCRIPTION==תיאור הרשאה
REMOVE ALL==להסיר הכל
ALL  RIGHTS==כל ההרשאות
USER MENU==תפריט משתמש
TABLE ==טבלה
CAN ADD ==יכולת להוסיף
CAN MODIFY ==יכולת לעדכן
CAN DELETE ==יכולת למחוק
LINE_NO==מספר שדה
TABLE DESCRIPTION==תיאור טבלה
CAN ADD==יכולת להוסיף
CAN DELETE==יכולת למחוק
CAN MODIFY==יכולת לעדכן
GROUPS LIST==רשימת קבוצות
GROUP NAME ==שם קבוצה
GROUPS RIGHTS==הרשאות קבוצה
RIGHTS==הרשאות
RIGHTS LIST==רשימת הרשאות
RIGHT NAME ==שם הרשאה
MENU ID==קוד תפריט
MENU DESCRIPTION==תיאור תפריט
INVALID NUMBER==מספר לא נכון
CHANGES WHERE NOT SAVED IN GRID DESIGN! CONTINUE ?!==!? שינוים לא נשמרו בתכנון רשת, המשך
VAT_VALUE==*
SEL TRY==*
SOURCE==*
DESTINATION==יעד
ERROR - ONLY SQL OR DB TABLES OR BATCH==*
ARE YOU SURE==? את/ה בטוח/ה
USERPASS==סיסמה
USERADDR==כתובת
USERPHONE==טלפון
USERMENUID==קוד תפריט
CREATED_BY==הוקם על-ידי
ORDER_CREATED_BY==הזמנה הוקמה ע"י
FIXED AMOUNT==סכום קבוע
DELETE PRICE !?==!? למחוק מחיר
REF NO==*
REF DATE==*
TRNZACTION NO==*
PERIOD START==*
TOTAL CREDIT==סה"כ אשראי
TOTAL DEBIT==סה"כ חובה
REF TYPE==*
REF TRN==*
REF1 TYPE==*
REF1 BRANCH==*
REF1 NO==*
LINE NO==מס' שורה
OPP ACCOUNT NO==*
LOCAL AMMOUT==*
DELAYED CHEQUES==צ'קים דחויים
R==*
PLEASE TYPE A SHORTCUT==*
STATUS FROM==מסטאטוס
STATUS TO==עד סטאטוס
MODIFICATION TYPE==*
LINE==שורה
INV BRANCH==סניף חשבונית
INV NUMBER==מס' חשבונית
ERROR - NO TABLE NAME DEFINED==*
DO YOU WANT TO DELETE CONTRACT NUMBER :==את/ה בטוח/ה שברצונך למחוק הסכם מספר
ARE YOU SURE YOU WANT TO DELETE THIS ACCOUNT?==? את/ה בטוח/ה שברצונך למחוק את החשבון
ALL FIELDS ARE VITAL! PLEASE INSERT.==כל השדות חיוניים ! נא למלא את כולם
DESCIPTION==*
MAX G0==*
MAX G1==*
MAX G2==*
MAX G3==*
MAX G4==*
MAX G5==*
MAX G6==*
MAX G7==*
MAX G8==*
MAX G9==*
MAX G10==*
MAX G11==*
MAX G12==*
MIN G0==*
MIN G1==*
MIN G2==*
MIN G3==*
MIN G4==*
MIN G5==*
MIN G6==*
MIN G7==*
MIN G8==*
MIN G9==*
MIN G10==*
MIN G11==*
MIN G12==*
OPT G0==*
OPT G1==*
OPT G2==*
OPT G3==*
OPT G4==*
OPT G5==*
OPT G6==*
OPT G7==*
OPT G8==*
OPT G9==*
OPT G10==*
OPT G11==*
OPT G12==*
WGT 0==*
WGT 1==*
WGT 2==*
WGT 3==*
WGT 4==*
WGT 5==*
WGT 6==*
WGT 7==*
WGT 8==*
WGT 9==*
WGT 10==*
WGT 11==*
WGT 12==*
COLORS==צבעים
TYPE ALLREADY EXISTS==הסוג כבר קיים
NEXT_STATUS_1==סטאטוס ראשון
NEXT_STATUS_2==סטאטוס שני
NEXT_STATUS_3==סטאטוס שלישי
COLOR CODE 1==צבע שני
COLOR_CODE_2==צבע שלישי
COLOR CODE==צבע ראשון
ACCOUNT :==חשבון
PRODUCED INVOICES==הפקת חשבוניות
DON'T PRINT==אל תדפיס
DATA WAS NOT COLLECTED FROM ALL PLANTS , CONTINUE ?==? נתונים לא נאספו מכל המפעלים, להמשיך
IMPROPER VALUE==ערך לא נכון
: FIELD DOES NOT EXIST ==ששדה לא קיים -
RELATIVE MAT GROUP ==קבוצת תלות חומרים
RELATIVE GROUP ==קבוצת תלות
MODIF GROUP ==קבוצת הפעלה
CEMENT MODIF BOOKS ==ספרי הפעלה לצמנט
GRD SPECIFICATION IS MISSING==חסר פירוט דירוג
CUSTOMER ORDERS VIEW==הצג הזמנות ללקוח
ACTIVATE==להפוך לפעילה
CREATE LIKE==יצר העתק
TRANSFER==העברה
SEPARATE==נפרד
OPERATION_BOOK_NUMBER==מס' ספר הפעלה
PLEASE ENTER QUANTITY==נא להקליד כמות
YOU HAVE REACHED THE LOWEST LEVEL==הגעת לרמה הנמוכה ביותר
FROM_SITE==מאתר
TO_SITE==עד אתר
STRING==*
TOTAL SELECTED :==סה"כ נבחר
SELECT==בחר
INVOICE DATE==תאריך חשבונית
PAY_NOW==לתשלום עכשיו
RECEIPTS LINES==שורות קבלות
&OK==אשר
&CANCEL==בטל
REMAIN==נישאר
CUSTOMER CREDIT==זכות לקוח
WALKIN NAME==שם לקוח מזדמן
&DELETE==מחק
&ADD==הוספה
SELECT INVOICES==בחר חשבוניות
AMOUNT CONVERTED==סכם המרה
CREATE THE RECEIPT ?==? להקים קבלה
FOR_INVOICES==לחשבונית
ANNULLED==מבוטל
SEC PAYMENT TYPE==סוג תשלום שני
ACTUAL DATE==*
RECEIPT AMOUNT==סכום קבלה
BRANCH CONNECTION==*
NO CONNECTION==*
LINE CONNECTION==*
OPERATION TYPE ==סוג הפעלה
RAW MATERIAL GROUP==קבוצת חומרי גלם
RAW MATERIAL ==חומרי גלם
ITEM_WAIT==פריט המתנה
FILE==קובץ
TECH SYS==טכני
REMARK TYPE ==סוג הערה
DATE&TIME==תאריך ושעה
CUSTOMER CODE==קוד לקוח
ITEM_PART==פריט הובלה חלקית
SUPLLIER ACCOUNT==חשבון ספק
SUPPLIER TYPE==סוג ספק
INVALID SHIP DOCK NO==מס' ת.מ. לא נכון
INVOICE HAS BEEN PRODUCED SUCCESSFULLY==! חשבונית יוצרה בהצלחה
INVOICE DELETE==מחיקת חשבונית
ARE YOU SURE YOU WANT TO DELETE THIS INVOICE?==! את/ה בטוח/ה שברצונך לבטל חשבונית
ADDITIONAL CODE IS MISSING==! חסר קוד תוספת
PRIORITY==עדיפות
HIGH PRIORITY==עדופות גבוה
REGULAR PRIORITY==עדיפות רגילה
NO PRIORITY==ללא עדיפות
RETURNED CONCRETE MODIFICATIONS==הפעלה על לבטון חוזר (לפי דקות)
BASE ITEM DESCRIPTION==תיאור פריט בסיס
RAW MATERIAL CODE==קוד חומר גלם
SUPPLIER_NAME==שם ספק
ACTIVE DATE ==תאריך פעילות
MODIFICATION DATE ==תאריך עדכון
EMPLOYEE ==עובד
SET OFF_RAW_MATERIAL ==חומר לפיצוי
RAW MATERIAL GROUP ==קבוצת חומרי גלם
SET OFF GROUP ==קבוצה לפיצוי
RATIO ==יחס
ITEM MASK ==פריט
MODIFICATION ==שינוי
RAW MATERIAL/GROUP==קבוצת חומרי גלם
SET OFF RM/GROUP==קבוצה/חומר לפיצוי
MULT==מקור
DIV==מחולק
SAVE CHANGES ?!==!? לשמור שינוים
MODIF==שינוי
INVALID TIMING==תזמון שגוי
SHIP_ADDITION==תוספת
SHIP_ADDITIONS==תוספות
SELECT TRANSACTION==בחר עסקאות
MODIFICATIONS==התאמה
UNT/PER==יחידה
RM REPLACE ==חומר מחליף
SELECT SITE==בחירת אתר
SELECT RAW MAT ==בחירת חומר גלם
GRADING BY ==דירוג לפי
PREVIOUS NAME==שם קודם
VALID UNTIL==בתוקף עד
RET. QNT==לאחר תיקון
RET. REAL QNT==כמות חוזרת
TO_DATE==עד תאריך
CANCEL LAST CHANGES ?!==?! לבטל שינוים אחרונים
WATER==מים
SILO_10==סילו 10
SILO_11==סילו 11
SILO_12==סילו 12
SILO_13==סילו 13
SILO_14==סילו 14
SILO_15==סילו 15
SILO_16==סילו 16
SILO_17==סילו 17
AGGREGATES==אגרגטים
ADDED_SUPER==מוסף על
ADDED_DELAY==מוסף מעכב
ADDED_CEMENT==תוספת צמנט
ITEMS ACCOUNTS DEFINITIONS (E)==*
PLANT/BRANCH==מפעל
UNTAXED DEBIT==חובה ללא מס
UNTAXED CREDIT==אשראי ללא מס
FOREIGN DEBIT==חובת זר
FOREIGN CREDIT==אשראי זר
BBK_NAME==שם ספר אב
FOREIGNERS==זרים
FIXED==קבוע
CEMENT_REQ_QNT==כמות צמנט מתוכננת
HOUR==שעה
MINUTE==דקה
SHD_DAY==יום
SHD_MONTH==חודש
SHD_YEAR==שנה
SHD_TOTAL==סה"כ לתעודה
SHD_PROD_QNT==יוצר
SHD_TOTAL_QNT==*
SHD_CEMENT_TOTAL==*
CALC_ITEM==*
CONCRETE==בטון
MORTAR==טיט
UNTIL_DATE==עד תאריך
REGULAR (NOT WALKIN==*
TBL_ADDITIONS==טבלת תוספות
TBL_OPER==*
SILO_OBJECT_TYPE==*
DOC_NAME==*
DOC_APPL==*
PASS 0==נפה 0
PASS 1==נפה 1
PASS 2==נפה 2
PASS 3==נפה 3
PASS 4==נפה 4
PASS 5==נפה 5
PASS 6==6 נפה
PASS 7==נפה 7
PASS 8==נפה 8
PASS 9==נפה 9
PASS 10==נפה 10
PASS 11==נפה 11
PASS 12==נפה 12
EXT. BASE==*
EXT. COST==*
EXT. DISCOUNT==*
MAIN_GROUP==קבוצה ראשונה
SECONDARY_GROUP==קבוצה שניה
THIRD_GROUP==קבוצה שלישית
SUM_ITEM_PRICE==סה"כ לפריט
SUM_WAIT_PRICE==סה"כ להמתנה
SUM_TRANS_PRICE==ס"כ להובלה
SUM_ADDITIONALS_PRICE==סה"כ לתוספות
OWNER_BUTTON==בעלות
DRV_NAME==שם נהג
LAST_STOCK_DATE==ספירת מלאי אחרונה
MESSAGES ==הודעות
END_QNT==כמות סופית
TEST_ID==קוד בדיקה
TOTAL_QNT==סה"כ כמות
CALC_QNT==כמות מחושבת
CALC_REAL_QNT==כמות מחושבת אמיתית
RAW_QNT==כמות חומרי גלם
SUM_RAW_CALC==סה"כ כמות מחושבת
SUM_RAW_QNT==סה"כ כמות חומר
REFRASH UNTIL ==רענן עד
REFRESH INVENTORY==רענן מלאי
TRUCK_CODE==קוד משאית
MINIMUM==מינימלי
MAXIMUM==מקסימלי
COUNTER==מונה
CONTRACT NUMBER : ==: מס' הסכם
THE TRUCK ALLREADY IN WORK==המשאית כבר בהעמסה
TERMINAL STATUS DOES NOT FIT ORDER STATUS==*
SELECT PLANT ==בחר מפעל
TOT_D_CHK==סה"כ דחוים
SITE TYPE==סוג אתר
SITE STATUS==סטאטוס
REFRESH UNTIL ==רענן עד
PRICES MODIFICATIONS==ביצוע התיקרויות
PRICES MODIF. ENTRY==תכנון התיקרויות יזומות
EXCEL FILE PATH==*
START ROW==*
START COLUMN==*
SHORT ENGLISH DESCRIPTION==קוד פריט בעידן
APPLICATION GENERATOR==מחולל יישומים
LIEN MANAGEMENT==ניהול בטחונות
GENERAL PRICE LISTS==רשימת מחירונים
SITE ZONES==אזורי אתרים
STOCK ENTRY - SINGLE==כניסת חומר גלם
STOCK ENTRY - MULTIPLE==כניסת חומרים שונים
DE&LETE==מחיקה
FIND==חיפוש
CONTRACT NO==מס' הסכם
CARTAGE CONTRACT==הסכם הובלה
INDEX PERCENT==אחוז התיקרות
CONTRACT :==הסכם
CUSTOMER NAME :==שם לקוח
LIEN VIEW==הצג בטחונות
ACTIVE STATUS==סטאטוס פעיל
NOT ACTIVE==לא פעיל
LIENS==בטחונות
LIEN TYPE==סוגי בטחונות
LIEN OPERATIONS==פעולות על בטחונות
REAL AMOUNT==סכום בפועל
CALC AMOUNT==סכום מחושב
REFERENCE==אסמכתה
SELECT RAW MAT==בחירת חומר גלם
GRADING BY==דירוג לפי
% PASS==% עובר
% REMAIN==% נישאר
% ABS==% נישאר על כל נפה
SELECT GRADING TYPE==בחר סוג דירוג
REFRESH UNTIL==רענן עד
CREATE LOAD==הנפק תעודה
PLAN==תכנון
ACTIVE ORDERS==הזמנות פעילות
CURRENT QNT:==לספק כעת:
NEXT SUPPLY TIME:==העמסה הבאה:
PENDING LOADS LIST==רשימת תעודות בהמתנה
MANUALLY ACTIVATED LOADS==תעודות לשליחה ידנית
PLANT :==מפעל
DISPATHER :==סדרן
BY DISPATCHER==לפי סדרן
AUTOMATIC==אוטומטי
ITEM SELECTION==בחירת פריט
SELECT DRIVER==בחר נהג
SELECT TRUCK==בחר משאית
PRODUCTION SOURCE==קוד יצור
SELECT OPTION==בחר אפשרות
SELECT PLANT==בחר מפעל
SELECT DISPATCHER==בחר סדרן
SELECT BATCH TERMINAL==בחר מסוף
REQUEST DATE + TIME==תאריך ושעה
ADD ITEM==הוספת פריט
WRONG PASSWORD !==! סיסמה לא נכונה
SITE_NAME==שם האתר
SITE NAME==שם האתר
VOLUME==נפח
DRV.NAME==שם נהג
SHIP.D NUM.==מס' ת. משלוח
PLACED BY==הוזמן על-ידי
DATETIME==תאריך
INCLUDE TRANSPORTATION==לכלול הובלה
FREQUENCY==תדירות
TERMINATION==סיום
ARRIVAL==הגעה
START POURING==תחילת יציקה
DEPARTURE==עזיבה
RETURN PLANT==חזרה למפעל
NEW PLANT==מפעל חדש
SHIP DOCK CAN NOT BE CANCELED==לא ניתן לבטל ת. משלוח
CONCRETE AND TRUCKS PLAN==תוכנית עבודה
- QUANTITY==- כמויות
- TRUCKS==- משאיות
HOURS :==שעות:
TIME FRAME :   (IN MINUTES)==מסגרת זמן בדקות
FIELD NOT FOUND==השדה לא נמצא
TBL==*
REC==*
TRUCKS COUNT CANNOT BE EQUAL TO 0!==! מספר משאיות לא יכול להיות שווה ל-0
ATTENTION CHECK CUSTOMER CREDIT !==! שים-לב, בדוק אשראי הלקוח
FREQUENCY OR TERMINATE DATE TIME ARE MISSING==! חסר תאריך של תדירות או סיום
TERMINAL==מסוף
DISCHARGE==פריקה
RESET==איתחול
PENDING LOADS==תעודות בהמתנה
ENTER THE DEFAULT SITE FOR DISTANCE CALCULATION==הקלד אתר ברירת מחדל לחישוב טווח
MIROR SITE==אתר למרחקים
ENTRY DATE==תאריך הכנסה
IMPORT/EXPORT DEFINITIONS==הגדרת יצוא/יבוא
EXTERNAL PROGRAMS==תוכניות חיצוניות
CAN NOT SUPPLY TO THIS CUSTOMER !==! אין אפשרות לספק ללקוח זה
PRINT SUB TABLES==הדפס טבלאות משנה
DATABSE SELECTION==*
BRANCH FIELD==*
NUMBER FIELD==*
SELECT DETAILES INPUT TYPE==*
SELECT GRID INPUT TYPE==*
LANGUAGE DIRECTION==כיוון שפה
REFRESH RATE==קצב ריענון
DETAILS TABLE==טבלת פרטים
SUMMARY==סיכום
CONSTRUCTOR TABLE==טבלת בניה
DESIGN GROUP==קבוצת תכנון
VIEW GROUP==הצג קבוצה
ADD GROUP==הוסף קבוצה
MODIFY GROUP==עדכון קבוצה
LINE TYPE==סוג רשומה
SELECT BATCH OPERATION==בחירת פעולת אצווה
SELECT IMP/EXP DEF==בחירת הגדרת יצוא/יבוא
PARAMS STRING==*
PARAM NO==*
LABEL==תווית
PARAM TYPE==סוג פרמטר
TYPE NAME==שם הסוג
IP_ADDR==IP כתובת
IP_PORT==IP יציאת
INTERNAL_ID==קוד פנימי
ENABLE_BATCHS==*
SCALE_INFO==*
+1==*
+5==*
+10==*
-1==*
-5==*
-10==*
-TOTAL-==סיכום -
WAITING TO BATCHER TO DISCHARGE==ממתין לפריקה >
CHECK TRUCK NO==בדוק מס' משאית
TRUCK ID==קוד משיאת
SYSTEM READY FOR NEW BATCH/LOAD==מערכת מוכנה להעמסה נוספת >
WAITING DISCHARGE TO END==ממתין לסיום פריקה >
SHIPING DOCKET NO==מס' תעודת משלוח
SAVE ?==? לשמור
CONNECTION FAILED==התחברות נכשלה
DB MANAGEMENT==ניהול בסיסי נתונים
DB LIST==רשימת בסיסי נתונים
CHECK CONNECTION==בדיקת התחברות
TRN FILE==קובץ העמרה
INI FILE_EDIT==INI עריכת קובץ
EDIT INI FILE==INI עריכת קובץ
TRN FILE EDIT==עריכת קובץ העמרה
EDIT TRN FILE==עריכת קובץ העמרה
TRUCK IS IN PRODUCTION !==! המשאית כבר בייצור
PRODUCTION HAS STARTED - CAN NOT REMOVE FROM TERMINAL==היצור כבר התחיל - לא ניתן להסיר מהמסוף
CURRENT TEMP SHIP DOCKET DELETED==התעודה הנוכחית נמחקה
WAITING FOR WEIGHTING TO START==ממתין לתחילת שקילה
QUOTES MANAGEMENT==ניהול הצעות
CALC SUPP. TICKETS==חישוב תעודות ספקים
PRICE MODIFICATIONS==שינויי מחירים
CONTRACTS_LIST==רשימת הסכמים
BATCH MODIFICATIONS==שינוי יזום
PRICES LIST==רשימת מחירים
PRICE MODIFICATIONS ENTRY==הגדרת התיקרויות
PRICE MODIFICATIONS BATCHES LIST==רשימת התיקרויות יזומות
DATE AND TIME==תאריך ושעה
PRICE MODIFICATIONS DETAILES==פרטי התיקרויות
MODIF TYPE==סוג שינוי
ROUND TO==לעגל ל-
QUOTES VIEW==הצג הצעות
QUOTES==הצעות
REVISE==שינוי
CONTACT PERSONS==אנשי קשר
CONTACTS==התקשרוית
MAIL ADDRESS==כתובת
MAIL FAX==פקס
PHONES==טלפונים
CONTACT PERSON SEARCH==חיפוש איש קשר
SITE ADDRESS==כתובת האתר
PREVIOUS QUOTE==הצעה קודמת
QUOTE LINES==שורות הצעות
REDUCTION==הפחתה
REDUCTION 1==הפחתה שניה
ITEM PRICE 1==מחיר פריט שני
REDUCTION 2==הפחתה שלישית
ITEM PRICE 2==מחיר פריט שלישי
LEVEL 1 (QNT)==רמה 1 - כמות
LEVEL 2 (QNT)==רמה 2 - כמות
REDUCTION TYPE==סוג הפחתה
PHONE 1==טלפון נוסף
SALESMAN==איש מכירות
FORWARD==העברה
STOCK ENTRY (MULTIPLE)==כניסת מלאי כפולה
SUPPLIER  DETAILS==פרטי ספק
SUPP. PLANT==מפעל ספק
SUPP. TICKET NUMBER==מס' תעודת ספק
TRUCK  AND TRAILER==משאית ונגרר
TRANSPORTER==מוביל
TRANSPORTER DOCKET==תעודת הובלה
STOCK ENTRY (SINGLE)==כניסת מלאי
NEW QUOTE==הצעה חדשה
CONTACT PERSONS VIEW==הצג אנשי קשר
MOBILE PHONE==טלפון נייד
POSITION==מיקום
FIRST NAME==שם
LAST NAME==משפחה
CREATED SUCCESSFULLY QUOTE NO==ההצעה הוקמה בהצלח מס'
LEVEL 1==רמה 1
LEVEL 2==רמה 2
UPDATE QUOTE==עדכון הצעה
BASE CONTRACT IS MISSING OR MISTAKEN==הסכם בסיס חסר או שגוי
- AVAIL. QNT==פנוי העמסות
- AVAIL. TRUCKS==פנוי במשאיות
RESULTS==תוצאות
GRADING TYPE==סוג דירוג
RAW MAT PRICES==מחירי חומרי גלם
WATER CEMENT RATIO==יחס מים-צמנט
RATIO==יחס
WATER QUANTITY DEFINITION==כמות מים לפי ס. גרגרים
FINENESS MODULUS==סיפרת הגרגרים
RECOMENDED WATER QUANTITY==כמות מים למ"ק
WATER QUANTITY==כמות מים
SYSTEM STRUCTURE==מבנה המערכת
WARM SILOS GRADING DATA ENTRY==כניסת נתוני דירוג סילוסים חמים
TICKETS REPORT==דו"ח כרטיסים
DESCRIPTION ENG==תיאור באנגלית
RELATIVE==יחס
MAT GROUP==לקבוצה
RELATIVE GROUP==קבוצת התיחסות
MODIF GROUP==קבוצת הפעלה
RM REPLACE==חומר מחליף בבטון חוזר
CREATE NEW SITE?!==?! לבנות אתר חדש
CALC. DATE==תאריך חישוב
BACKWARD DAYS==ימים אחורה
TOTAL COST==סה"כ עלות
TOTAL_KG==סה"כ ק"ג
TBS_DESIGN==תכנון
MIXTURE TICKET==כרטיס תערובת
CLICK TO RECALC==לחץ לחישוב מחדש
DATA BASE==נתונים
% FROM AGGRAGATES==% אגר.
ACTUAL==ריאלי
J.M.F==רצוי
BATCH TICKET GRAPH==*
X = ?==*
GRADE NO.==מס' דירוג
GRADE SIZE==מידת דירוג
LOG(GRADE SIZE)==לוגריטם
SHOW MIX GRADING==הצג דירוג
SHOW MAX VALUES==הצג ערכים מקס
SHOW MIN VALUES==הצג ערכים מינ
SHOW OPT VALUES==הצג ערכים אופט
AGREGATES GRADING CURVE==עקומת דירוג אגרגטים
MIXTURE GRADING CURVE==עקומת דירוג תערובת
OPT==מיטבי
PHISCAL_SILOS==סילוסים פיזים
REMARK TYPE==סוג הערה
SPLIT MAIN==פיצול עיקרי
CALC_FACTOR==חישוב פקטור
EXCEED_MAX_CREDIT==לאפשר חריגת אשראי
GROUP NAME==שם קבוצה
RIGHT NAME==שם הרשאה
INVALID INTEGER DATA...!..!!..!!!==! הערך חייב להיות מספרי
COMPANY_CODE==קוד חברה
FOLLOW_UP==מעקב
NEXT_STATUS==סטאטוס הבא
HAS_STOCK==מחושב במלאי
IN_TANK==בסילו
DONT_MULT==*
ROUND==עגול
BASE==בסיס
CRM==התקשרות ללקוח
ACCOUNT NAME:==שם לקוח
ACCOUNT NUMBER:==קוד לקוח
THIS CONTRACT ALREADY EXIST.==ההסכם כבר קיים
NO CONTRACT TO SAVE==אין הסכם לשמירה
OPERATION TYPE==סוג הפעלה
OPER.TYPE==סוג הפעלה
FOLLOW UP DATE==תאריך מעקב
CONTRACT DATE==תאריך הסכם
ACTIVE VERSION DATE==תאריך הפעלה
CALC MODE==אופן חישוב
INDEX TYPE==סוג מדד
DISPLAY VERSION==גירסה
FIXED PER KM==לפי ק"מ
FIXED PER UNIT==לפי יחידה
PER UNIT==לפי יחידה
TRUCK TYPE==סוג משאית
PARTIAL_TRANSPORT COST==עלות הובלה חלקית לכל קוב חסר
NO DISCOUNT==ללא הנחה
SCALE-TRON INC.==SCALE-TRON INC
CEMENT QTY==כמות צמנט
WATER QTY==כמות מים
SIEVE ANALYSIS DATA ENTRY==רישום דירוגי חומרי גלם
WARM BINS SIEVE ANALYSIS DATA ENTRY==רישום דירוגי אספלטים
GROUP DELETE==מחיקת קבוצה
ARE YOU SURE YOU WANT TO DELETE THIS GROUP?==!? האם את/ה בטוח/ה במחיקת קבוצה
PRODUCTION TICKETS==כרטיסי יצור
REBUILD==בניה מחדש
GRADING ENTRY==הכנסת דירוג
WARM SILO MATERIAL==חומר בסילו חם
MENU MANAGER==מנהל תפריט
SELECT BATCH UNIT==בחר מסוף
SELECTIONS==בחירה
FROM ITEM==מפריט
TO ITEM==עד פריט
MASK==מסיכה
DO CALC GRADING==בצע חישוב דירוג
DO CALC PRICE==בצע חישוב מחיר
BUILD==בניה
CLEAR VIEW==נקה תצוגה
RAW MATERIAL LIST==רשימת חומרי גלם
R. MATERIAL CODE==קוד חומר גלם
R.MATERIAL DESCRIPTION==תיאור חומר גלם
SUPPLIER PLANT==מפעל ספק
NEW RAW MATERIAL PRICE==מחיר חומר גלם חדש
R. MAT==חומר גלם
NEW PRICE==מחיר חדש
EXIT WITHOUT SAVING NEW PRICE ?!==!? יציאה ללא שמירה
0 - 10==10-0
10 - 20==20-10
20 - 30==30-20
30_45==45-30
45 - 60==60-45
60 +==*
GRADING CURVES DEFINITION==הגדרת עקומת דירוג
DATA ENTRY==הכנסת נתונים
TEST RESULTS==תוצאות בדיקה
MAXIMUM VALUES==ערכים מקסימלים
MINIMUM VALUES==ערכים מינימלים
OPTIMUM VALUES==ערכים אופטימלים
INVALID SUPPLIER CODE==קוד ספק שגוי
SPECS IS MISSING==חסרה עקומת דירוג
MIXTURE GRADATION==דירוג תערובות
GRADATION CURVES==עקומות דירוג
AGGREGATES GRADATION CURVES==עקומות דירוג אגרגטים
SIEVE NO.==מס' נפה
SIEVE SIZE==גודל נפה
LOG(SIEVE SIZE)==לוגריטם
ACCUMULATIVE GRADATION CURVE==עקומת דירוג מצטברת
AGGREGATES GRADATION CURVE==עקומת דירוג אגרגטים
MIXTURE GRADATION CURVE==עקומת דירוג תערובת
NEW MODIF BOOK==ספר הפעלה חדש
SET OFF_RAW_MATERIAL==חומר לפיצוי
SET OFF GROUP==קבוצה לפיצוי
RAW MAT. DEFINITIONS==הגדרות חומרי גלם
DEFAULT MAXIMUM MODIFICATION ALLOWED==סטיה מותרת מקסימלית
UP==מעל
DOWN==מתחת
ENTER NEW_CODE...==הקלדת קוד חדש
BOOK NO IS MISSING !==! חסר מספר ספר אב
NEW BATCH BOOK ITEM==פריט חדש בספר אב
DUPLICATE==העתקה
DUPLICATION SOURCE==העתקת מקור
SITE IS MISSING==! חסר אתר
CONDITIONS==תנאים
SELECT DATES==בחר תאריכים
GRADES TEST==בדיקת דירוג
MESSAGE TYPE==סוג הודעה
MESSAGE TYPE IS MISSING !==! חסר סוג הודעה
INVALID PLANT CODE==קוד מפעל שגוי
SIEVE ANALYSIS DATA==דירוגי חומרי גלם
TEST TIME==תאריך בדיקה
GRADES GRAPH==תרשים דירוג
SHOW TEST RESULTS==הצג תוצאות בדיקה
COMPLAINTS VIEW==הצג תלונות
COMPLAINTS==תלונות
RESPONSIBLE EMPLOYEE==אחראי
ORDER (PLANT AND NUMBER)==הזמנה - מפעל ומספר
TICKET (PLANT AND NUMBER)==תעודה - מפעל ומספר
SAMPLE ORDER==הזמנת מדגם
SAMPLE==מדגם
PLANTS RELATION==קישור למפעלים
ILLEGAL PRICE VALUE==ערך מחיר לא חוקי
GPS_EAST==GPS מזרח
VAT TYPE==סוג מע"מ
DISPLAY VERSION #==גירסה #
TRANS CONTRACT==הסכם הובלה
INVALID WAITING COST==עלות המתנה לא חוקית
FOLLOWUP PERIOD==התקשרות הבאה
TYPE VALUE IS MISTAKEN!==! סוג ערך שגוי
DO YOU WANT TO RESTORE CONTRACT NUMBER :==ברצונך לשחזר הסכם
PLANT RELATION==קישור למפעלים
SUMMARY TYPE==סוג סיכום
PERIODIC==תקופתי
AVAILABLE FIELDS==שדות זמינים
LINKS==*
PERIODIC SUMMARY DEFINITION==הגדרת סיכום תקופתי
START DATE :==תאריך התחלה
# OF STEPS==מס' שלבים
WEEKS==שבועות
STEP DEFINITION==הגדרת שלב
CONNECTED==מחובר
DISCONNECTED==מנותק
WRONG DEFINITION ON :==-הגדרה לא נכונה ל
DELETE THE BU_SILO ?==?למחוק סילו
STOP PROC.==עצור
IP_ADDRESS==IP כתובת
NOT AN INTEGER VALUE....!!==!! ערך לא מספרי
IDLE==חסר ערך
SHIPPING DOCKETS==תעודות משלוח
REQUEST DATETIME==תאריך הזמנה
RAW MATERIAL IS MISSING==חסר חומר גלם
DELETE CURRENT SHIP DOCKET ?!==!? למחוק ת. משלוח נוכחית
THE TOTAL PERCENTAGE IS NOT 100%, FOR==סה"כ אחוז לא %100 עבור >
WAITING TO END WEIGHTING==ממתין לסיום שקילה >
OPERATION ALARM==תקלה! -
FROM NUMBER :==ממספר
TO NUMBER :==עד מספר
CHANGE SILO==החלפת סילו
LBL_EMPTY_SILO==*
SELECT ONE OF THE OPTIONS :==בחר אחת האפשרויות
FLOW PROBLEM WAS FOUND ON THIS SILO==בעית זרימה בסילו
SELECTION LIST==רשימת בחירה
ACCOUNTING DEF.==הנה"ח
NEXT SUPPLY DATETIME==זמן אספקה הבאה
INTERNAL CUSTOMERS==לקוחות פנימים
INVALID DRIVER CODE==קוד נהג לא נכון
TRUCK_ID==קוד משאית
REOPEN ORDER==להפעיל
VIEW ORDERS==הצג הזמנות
ITEM EXIST==הפריט כבר קיים
OMNA TECHNOLOGIES LTD.==אומנה טכנולוגיות בע"מ
INVALID TYPE==סוג לא נכון
SAVE NEW PRICE ?!==?! לשמור מחיר חדש
VIEW TABLES==הצג טבלאות
DELETE PLANT LINE==למחוק רשומת מפעל
PLANT RELATION VIEW==הצג קישור למפעל
CUSTOMER RECORD==רשומת לקוח
MODIF CODE IS MISSING !==! חסר קוד שינוי
DO YOU WANT TO UPDATE SELECTED CONTRACTS PRICES ?==ברצונך לעדכן מחירים שנבחרו ?
DO YOU WANT TO UPDATE PRICES OF SELECTED CONTRACTS ACCORDING TO INDEX?==ברצונך לעדכן מחירים בהסכמים שנבחרו לפי מדד ?
DATE ALLREADY EXISTS==התאריך כבר קיים
INDEX  PERCENTAGE:==אחוז התיקרות
TRANSPORTATION DEFINITIONS==הגדרות הובלה
ARE YOU SURE ?==? את/ה בטוח/ה
ACCOUNTS DEF.==הנה"ח
SITE SELECTION==בחירת אתר
TICKET_PRINT_TBL==סוג תדפיס ת. משלוח
TICKET_PRINT_TBL_2==סוג תדפיס נוסף
TICKET_PRINT_TBL_3==סוג תדפיס שלישי
NUM_OF_COPIES==מספר עותקים
AUTO INDEX :==מדד קבוע
CANCEL/STORNO RECEIPT==בטל/זכה קבלה
DO STORNO==זיכוי חלקי
STORNO==זיכוי חלקי
PRINT TICKETS==הדפס תעודה
DRIVER NAME==שם נהג
LEAVE SITE DATE==זמן עזיבה
ARRIVE DATE==זמן הגעה
SHIP DOCK DATE==תאריך תעודה
SHIP DOCKET NUMBER==מס' ת. משלוח
TRANSPORTER DETAILS==פרטי מוביל
TRAILER==נגרר
TRANSPORTER TICKET NUMBER==תעודת מוביל
PN_SUPPLIER==ספק
QUALITY CONTROL==אבטחת איכות
QUALIY CONTROL STATUS==סטאטוס
CREATE QUALITY CONTROL SAMPLE==יצירת מדגם
ENTRY DATE AND TIME==תאריך הכנסה
PN_SILOS==סילוסים
SILOS==סילוסים
SILO==סילו
CONTRACT_BREAK==לפי הסכם
SITE_BREAK==לפי אתר
ITEM_BREAK==לפי פריט
DAY_BREAK==לפי יום
V 2.61 01/05/03==*
ALL SITES==כל האתרים
DATE+TIME==תאריך ושעה
UNIT DISCOUNT==יחידת הנחה
GRAND TOTALS==סכום כולל
TOTAL TAXS==סך מסים
TAXS==מסים
TAX_1==מס 1
TAX_2==מס 2
TAX_3==מס 3
TAX_4==מס 4
ENTRY ALL==את כולם
MAIN==כללי
EXTERNAL SUPP. PLANT==מפעל ספק בטון
SHIP DOCK NUM.==תעודת בטון קנוי
MAX_QTY==מקס. להפעלה
PRODUCTION CODE MUST BE DEFINED !==! קוד יצור חייב להיות מוגדר
EXTERNAL SUPPLIER AND PLANT MUST BE DEFINED !==! שדות של ספק ומפעל ספק לא יכולים להיות קרים
VIRTUAL BATCHING==יצור פיקטיבי
TRUCK NOT READY TO RETURN==המשאית לא מוכנה לחזרה
FILE NAME AND PATH==שם ומיקום הקובץ
ARE YOU SURE ?!==!? את/ה בטוח/ה
ACC TRN #==מס' פקודת יומן
TOTAL TAXES==סך מסים
TAXES==מסים
COMPULSORY TESTS==בדיקות חובה
AVAILABLE TESTS==בדיקות זמינות
MANUAL ID==קוד ידני
SAMPLE DATE  AND  TIME==תאריך ושעת מדגם
EXTERNAL REFERENCE==אסמכתה חיצונית
BATCH NUMBER==מס' מסוף
LOT NUMBER==מספר מנה
INTERNAL REFERENCE NUMBER==אסמכתה פנימית
ORDER NUMBER==מס' הזמנה
SAMPLE TYPE==סוג מדגם
REMARK DATE  AND  TIME==תאריך ושעת הערה
ADD REMARK==הוספת הערה
BUILD LINES==בנית שורות
REFERENCE NO==מס' אסמכתה
REFERENCE_DATE==תאריך אסמכתה
LINE DETAILS==פרטי שורה
LINKED INVOICES==חשבוניות מקושרות
LINK INVOICE==קישור חשבונית
CANCEL LINK==בטל קישור
LINKED RECEIPTS==קבלות מקושרות
LINK RECEIPT==קישור קבלה
LINKED DEPOSITS==הפקדות מקושרות
LINK DEPOSIT==קישור הפקדה
LINKED SUPPLIER INVOICES==חשבוניות ספק מקושרות
LINK SUPPLIER INVOICE==קישור חשבונית ספק
AFTER DESIGNING SAVE YOUR REPORT AS==שמור דו"ח אחרי תכנון
TO PLANT==עד מפעל
APPLY     -->==יישם -->
PLEASE INSERT ALL NECESSARY VALUES==נא להכניס את כל הערכים ההכרחים
CREATE==יצר
NO INTERNAL INVOICES TO LINK==אין חשבוניות חיצוניות לקישור
NO EXTERNAL INVOICES TO LINK==אין חשבוניות פנימיות לקישור
NO RECEIPTS TO LINK==אין קבלות לקישור
NO DEPOSITS TO LINK==אין הפקדות לקישור
NO INTERNAL SUPPLIER INVOICES TO LINK==אין חשבוניות פנימיות של ספק לקישור
NO EXTERNAL SUPPLIER INVOICES TO LINK==אין חשבוניות חיצוניות של ספק לקישור
WAS CREATED !==! היצור הסתיים
RECALCULATE ENTRY TICKETS==חשב תעודות מחדש
CALC TRANSPORTATION COST==חשב עלות הובלה
CHARGE METHOD==שיטת חיוב
ARRANGE PAYMENTS==הסדר תשלומים
PAYMENT DATE==תאריך תשלום
NO OF PAYMENTS==מספר תשלומים
WAS LINKED !==! מקושר
BATCH UNITS==עמדות יצור
ALLREADY IN PRODUCTION==כבר ביצור
ROUND_NUMBER==*
SELECT TRANSPORTER==בחר מוביל
QTY==כמות
RETURNED QTY==כמות חוזרת
CALCULATE TRANS. COST==חישוב בהסכם לקוח
BY CUSTOMER==ע"י לקוח
DEFINE==מספק ל
RAW. MAT. SUPP.==ספק חמרי גלם
HAULER==מוביל
CONC. SUPP.==ספק בטון
DEBIT ACC. #==חשבון חובה
CREDIT ACC. #==חשבון זכות
ELEMENT==אלמנט
ADD WATER==הוספת מים
BILLING==הגשת חשבון
BANK NO==מס' בנק
CHEQUE NO==מס' המחאה
SELECT RECEIPT LINE==בחר שורת קבלה
SELECT  ALL==בחר הכל
SELECT FOR DEPOSIT FROM==בחר להפקדה מ
THE BANK ACCOUNT DOES NOT BELONG TO THIS COMPANY==מס' בנק לא שייך לחברה
INVALID DATES RANGE==טווח שעות לא נכון
EXTERNAL SUPP. AND PLANT MUST BE DEFINED==ספק חיצוני ומפעל חייבים להיות מוגדרים
PLANT OR SUPPLIER DETAILS ARE MISSING!==! חסרים פרטי מפעל או ספק
ENTRY DOCKET WAS SUCCESSFULY REGISTERED !==! תעודת כניסת חומרים נקלטה בהצלחה
REMOVE INVENTORY COUNT ?==? למחוק ספירת מלאי
PNL_BRANCH_DESC==תיאור מפעל
INVENTORY READINGS==ספירות מלאי
GET BATCH PARAMS==קבל פרמטרי אצווה
BATCH OPERATION==פעולת אצווה
BATCH PARAMS==פרמטרי אצווה
GET PARAMETERS==קבל פרמטרים
FIXED_PRICE==מחיר קבוע
ITEM_PRICE==מחיר פריט
EXTRA_PRICE==מחיר מיוחד
TRANS_PRICE==מחיר הובלה
WAIT_PRICE==מחיר המתנה
ADDITIONALS_PRICE==מחיר תוספות
FIXED_TRANS_COST==עלות הובלה קבוע
RAW_MAT_COST==עלות חומרי גלם
TRANS_COST==עלות הובלה
WAIT_COST==עלות המתנה
ADDITIONALS_COST==עלות תוספות
CST_UTIL_CREDIT==אובליגו
DELETE ALL TEMP SHIP DOCKETS?==? למחוק כל התעודות הזמניות
DELETE TEMP SHIP DOCKET?==? למחוק תעודה זמנית
DOCKET NUMBER MUST BE ENTERED ON MANUAL DOCKETS==מס' תעודה חייב להיות רשום בתעודה ידנית
SITE_AGENT==סוכן האתר
EXPORT TABLE NOT FOUND==טבלת יצוא לא נמצאת
REPLACEMENTS== ספקים תחליפים
REPLACEMENT SUPPLIERS==ספקים תחליפים
ACTIVE REPLACEMENTS==תחליפים פעילים
REMARK :==הערה
NEW REPLACEMENT DETAILS==פרטי תחליף חדש
ACTIVATION DATE==תאריך לפעילות
INACTIVATE==להוציא מפעילות
SUPPLIER NAME==שם ספק
ACTIVATION REMARK==הערת כניסה לפעילות
INACTIVATION REMARK==הערת יציא מפעילות
CONTRACT ACTIVE VER DATE :==תאריך מדד בסיס
SUPPLIER AND PLANT CODES MUST HAVE VALID VALUES !==! ספק ומפעל חייבים ערכים חוקים בשדות
ARE YOU SURE YOU WANT TO INACTIVATE THIS SOURCE ?==? אתה בטוח שברצונך להוציא מפעילות מקור זה
SELECT UNPAID INVOICES==חשבוניות שלא שולמו
CASH ACCOUNTS==חשבונות קופה
CASH ACCOUNT NUMBER==מס' חשבון
FIRST CHARGE==תשלום ראשון
RAW MATERIAL NOT DEFINED PROPERLY IN INVENTORY SYSTEM==חומר גלם לא מוגדר היטב במערכת המלאי
ITEM_UNIT==יחידת משקל
DO YOU WANT TO RESTORE SELECTED CONTRACTS ?==? ברצונך לשחזר הסכמים שנבחרו
VER #:==גירסה
PERIODS AND DATES==תקופות ותאריכים
AUTO INDEX DEFINITIONS==הגדרת מדד אוטומטי
AUTO==אוטומטי
AUTO - ONLY UPWARDS==אוטומטי - רק עולה
AUTO - ONLY DOWNWARDS==אוטומטי - רק יורד
SUPPLIER IS NOT AUTHORIZED TO SUPPLY THIS RAW MATERIAL TO THE SPECIFIC PLANT !==! ספק זה לא מורשה לספק את החומר למפעל המוגדר
DELETE BATCH LINE==? למחוק שורת אצווה
GRADATION VIEW TYPE==סוגי הצגת דירוג
PASS==עובר
REMAINING==נשאר
ALL TRUCKS==את כולן
LOCAL TRUCKS==רק שלי
TRANSPORTER ADDITIONS==תוספות למוביל
REQ QTY==סה"כ כמות
REQ QTY/UNIT==כמות למ"ק
MOISTURE==לחות
DIFFERENCE==הפרש
V. PROD QTY==כמות בפועל
ONLY BASE MIXTURES==רק תערובות בסיס
CALC. GRADATION==חישוב דירוג
CALC. PRICE==חישוב מחיר
CALC. DATE AND BACKWARD DAYS==חישוב תאריכים
EFFECTIVE ON==דירוגים עד
BACK PERIOD (DAYS)==תקופה לאחור (ימים)
DELETE ALL RECORDS IN VIEW ?==? למחוק את כל הרשומות
ADD_AMOUNT==מחיר
TRUCK WAS CHANGED, CONFIRM ?==?משאית הוחלפה, להמשיך
LAST MODIFICATION==עדכון אחרון
CREATED ON==נוצר ב
CUSTOMER COMPLAINTS MANAGEMENT MODULE NOT INSTALLED==מודול לניהול תלונות לקוחות לא מותקן במערכת
CONTRACT NUMBER :==מס' הסכם
INVALID WAITING BASE==המתנה בסיסית שגויה
ALLOW SUPPLY WITHOUT PREDEFINED PRICE==אספקה ללא מחיר
PLEASE FILL ALL THE NECESSARY FIELDS==נא למלא כל השדות הנדרשות
SELECTED INVOICES==בחירת חשבוניות
AVAILABLE INVOICES==חשבוניות זמינות
MODIFY THIS CONTRACT ?==? לעדכן הסכם זה
PRICING CONTRACT==הסכם תמחיר
CREDIT ACCOUNT IS MISSING==חסר חשבון זכות
INCORRECT CUSTOMER==לקוח שגוי
GRADATION TEST==בדיקת דירוג
BATCH BOOK NO. IS MISSING==חסר מס' ספר אב
RM CODE==קוד חומר
PLANT SPECIFIC==הובלה למפעל
EX-FACTORY PRICES==מחירי שער המחצבה
RAW MATERIAL COST EX-FACTORY==עלות חומרי גלם בשער המחצבה
DISPATCHER OPERATIONS==פעולות סדרן
VIEW ORDER==הצג הזמנה
TIME DONE==שעת ביצוע
DATE DONE==תאריך ביצוע
TIME FRAME LOADS LIST==מסגרת הזמן של רשימת העמסות
START TIME==זמן התחלה
RETURN TIME==זמן חזרה
REMAIN QUANTITY==כמות נותרת
TOTAL QUANTITY==כמות לביצוע
USE PLANT DEFAULT BATCH BOOK==משתמש בספר אב של המפעל
NO DELIVERY IN LAST 24 HOURS==לא בוצע כלום ב-24 שעות אחרונות
ADD DOCKETS==הוסף תעודה
RAW_MAT==חומר גלם
SHD_REMARK==הערה לתעודה
ORD_REMARK==הערה להזמנה
DISPLAY ZERO QUANTITIES==הצג כמויות באפס
NO TYPE SELECTED==לא נבחר סוג
WRONG TYPE SELECTED==סוג הנבחר לא נכון
SECONDARY  PAYMENT TYPE==סוג תשלום נוסף
THIS ENTRY DOCKET ALREADY RECEIVED!==! התעודה כבר קיימת במערכת
MULT_BY==מוכפל לממשק הובלה
THIS ITEM DOES NOT HAVE A PRICE==! לפריט זה אין מחיר
BATCH TICKETS REPORT==דו"ח תערובות
UPDATE INVOICE DETAILES==עדכון פרטי חשבונית
NEW STATUS==סטאטוס חדש
NEW DUE DATE==תאריך פרעון חדש
SUPPLIER ACCOUNT==חשבון ספק
THIS INVOICE CAN NOT BE CANCELED !==! לא ניתן לבטל חשבונית זו
TOTAL RECEIPT :==: סה"כ לקבלה
AMOUNT TO PAY NOW :==: סכום לתשלום מייד
ENTER A CONTRACT/PRICE LIST NUMBER TO OVERRIDE THE SITE/CUSTOMER DEFINITION==הכנס מספר הסכם לשינוי הסכם המוגדר כברירת מחדל
DEFAULT CONTRACT/PRICE LIST==הסכם קבע של האתר
FROM TRANSACTION==מפקודת יומן
TO TRANSACTION==עד פקודת יומן
TRANSACTIONS LIST==רשימת פקודות יומן
INTERNAL DOCKET NUMBER==מס' תעודת כניסה
SUPPLIER DOCKET NUMBER==מס' תעודת ספק
ACCOUNTING TRANSACTIONS VIEW==הצגת פקודות יומן
TRANSACTION LINES==שורות פקודות יומן
FROM DOCUMENT SOURCE==ממקור
TO DOCUMENT SOURCE==עד מקור
VIEW ACCOUNTING TRANSACTIONS==הצגת פקודות יומן
ACTUAL QTY==כמות ריאלית
DIFFERENCE BETWEEN THE ACTUAL QTY AND THE REQUESTED QTY==הפרש בין כמוית המוזמנת להריאלית
INVALID CUSTOMER NO==מספר לקוח שגוי
WALKIN CUSTOMER NOT FOUND==לא נמצא לקוח מזדמן
NEW WALKIN CONTRACT==הסכם חדש ללקוח מזדמן
NOT ALL SHIPING DOCKETS ARE CLOSED - CAN NOT CLOSE THE ORDER !==! לא כל התעודות סגורות - לא ניתן לסגור את ההזמנה
THIS INVOICE IS PAID AND CAN NOT BE DELETED==החשבונית שולמה, לא ניתן לבטל אותה
BASE ONLY==בסיסי בלבד
LBL_CUST_NAME==לא נבחר לקוח
APPLY CUSTOMER RANGE==אשר תחום הלקוח
APPLY RANGE==אשר תחום
CLEAR RANGE==נקה תחום
DEFINE RANGE BY CUSTOMER==הגדרת תחום לפי לקוח
CUSTOMER NOT FOUND IN THE DATABASE !==! לקוח לא נמצא בבסיס נתונים
CHANGE_GROUP==קבוצה לשינוי
CASE SENSITIVE SEARCH==רגיש לגודל אות
SITE IS NOT ACTIVE !==! האתר לא פעיל
INVALID SQL OPERATIONS:==פעולת SQL לא תקינה
QNT MUST BE LESS THAN OR EQUEL TO TRUCK MAX WEIGHT==כמות צריכה להיות קטנה או שווה לנפח המקסימלי של המשאית
UNTIL DATE==עד יום
MFGD ONLY==*
INCLUDE EXTERNAL==לכלול פנימיים
SALES BY ITEM SUMMARY==מכירות לפי סיכום פריט
FIRST VALUE :==ערך ראשון
LAST VALUE :==ערך אחרון
# OF STEPS :==מס' שלבים
TRU_EXTRA_1==אחוז דמי שימוש
TRU_EXTRA_2==אחוז דמי ערבול
TRU_EXTRA_3==זיכוי מס
UNTIL_PLANT==עד מפעל
THIS_DATE==תאריך של היום
ACTUAL RETURNED QTY==כמות חוזרת ריאלית
QUANTITY FOR ORDER IS EXCEEDED!==! הכמות המוזמנת כבר סופקה להזמנה הזות
INV_BANK_NO==מס' הבנק
INV_BANK_BRANCH==סניף הבנק
NO DOCUMENTS IN RANGE==אין תעודות להצגה בטווח הנבחר
RCT_BASE_TABLE==טבלת הקבלות
RCT_SEC_TABLE==טבלת הקבלות נוספת
RCT_REMARK_TABLE==טבלת הערות
RCT_COPIES==העתקים לקבלות
ORDER IS REQUESTED IN THE PAST, CREATED AS A MANUALLY SERVED ORDER ?==? תאריך או שעת ההזמנה לא עתידיים! האם לשמור את ההזמנה עבור תעודות ידניות
DELETE THE COMPANY AND ALL SUB TREE ITEMS ?==? למחוק את החברה ואת כל הבנים
CANCEL PRODUCTION==לבטל כמויות יצור
CANCEL TRANSPORTER  PAYMENT==לבטל תשלום לנהג
CANCEL FIRST TRANSPORTATION==לבטל הובלה ראשונה
PROD QTY==כמות ליצור
ITEM NOT DEFINED==פריט לא מוגדר
ADDITION CODE==קוד תוספת
ADDITION DESCRIPTION==תיאור תוספת
TAXATION GROUP==קבוצת מיסוי
TAX CODE==קוד מס
DELETE BATCH BOOK NO==מחיקת ספר אב
BATCH BOOK ITEMS EXIST CONTINUE ?==? לספר אב ישנם פריטים, להמשיך
DELETE THE BRANCH AND ALL SUB TREE ITEMS ?==? מחיקת סניף/מפעל עם כל הפרטי העץ
ACCOUNT ALLREADY EXIST !==! החשבון כבר קיים
PLEASE FILL ALL NECESSARY FIELDS==נא למלא את כל השדות הנדרשים
CUSTOMER CODE IS MISSING==חסר קוד לקוח
INVALID PLANT==מפעל שגוי
COST PER UNIT IS MISSING==חסרה עלות ליחידה
TRUCK FEATURES==מאפייני משאיות
LBL_CUST_DIST==אין מרחק לקוח
LBL_CARR_DIST==אין מרחק הובלה
ACTUAL DISTANCE==מרחק ריאלי
PREV==קודם
ORDER #==הזמנה -
ORDER NUM==*
PRODUCTS==מוצרים
PRDCUCTS TAXS==מס מוצרים
PRODUCTS TAXS==מס מוצרים
DOC NUMBER==מס' מסמך
ITEMS_TAX_TABLE==טבלת מס לפריטים
RECEIPT DELETE==מחיקת קבלה
ARE YOU SURE YOU WANT TO DELETE THIS RECEIPT?==? אתה בטוח שברצונך למחוק את הקבלה
THE RECEIPT IS ALREADY CANCELED==! הקבלה כבר מבוטלת
NO LINKS==! אין קישורים
CAN NOT PERFORM THE OPERATION !==! לא ניתן לבצע את הפעולה
REGULAR SALES==מכירות רגילות
CAN NOT DELETE THE RECEIPT !==! לא ניתן לבטל את הקבלה
NO COMMUNICATION WITH DRIVER==! התוכנית התחברות לבקר לא פועלת
INCORRECT CUSTOMER DISTANCE==! טווח ללקוח לא נכון
SITE NOT ACTIVE==! האתר לא פעיל
CUSTOMER STATUS NOT ACTIVE==! סטאטוס לקוח לא פעיל
TIME ENTRY==כניסת זמן
SOME RECORDS ARE NOT READY FOR INVOICING==! יש תעודות לא סגורות
PLEASE INSERT ALL NECESSARY FIELDS!==! נא להכניס את כל השדות ההכרחים
QUANTITY ENTERED WILL EXCEED THE MAX QUANTITY IN THE SILO, CONTINUE ?==? כמות כניסת חומר גלם גבוהה מהקיבולת של הסילו, להמשיך
RAW MATERIAL QUANTITY IN THIS SILO MORE THAN MAX ENTRY!==! כמות החומר בסילו גבוה מכמות מקסימלית לכניסה
SPECIFIC PLANT COST==הובלה למפעל
EX-FACTORY COST==מחיר בשער המפעל
SAVE NEW EX-FACTORY COST?==? לשמור את המחיר החדש
NO PRICE ENTERED !==! לא נרשם מחיר
NEW EX-FACTORY DATE MUST BE GRATER THAN LAST DATE !==! התאריך החדש חייב להיות גדול מתאריך הקודם
CLOSING DETAILS==פרטי סגירת תעודה
WRONG AMOUNT==הסכום לא נכון
CUSTOMER EXCEEDED MAX. CREDIT==! הלקוח עבר את גובה האשראי
UNKNOWN==לא ידוע
LOCAL DISPATCHER NOT EQUAL TO SHIP DOCK DISPATCHER==הסדרן המקומי לא זהה לסדרן שהקים את התעודה
NO DELIVERY IN LAST 1.5 HOURS==לא הפקה תעודה בשעה וחצי האחרונה
SAMPLE ENTRY==המדגם ריק
MANUFACTURING PLANT==מפעל היצור
MANUFACTURING BATCH UNIT==בקר היצור
UNCALCULATED TRANZACTIONS IN DATABASE , TRY AGAIN AFTER RECALCULATION==! חלק מהתנועות לא מחושבות, נסה שוב לאחר חישוב מחדש
ILLEGAL RANGE==הטווח לא חוקי
SHIPING DOCKETS TO CLOSE==תעודות לסגירה
SHIPPING DOCKETS TO CLOSE==תעודות לסגירה
ZERO PRICE ON==אין מחיר לפריט בתעודה
TOTAL RECIEPT==סה"כ לקבלה
TOTAL RECEIPT==סה"כ לקבלה
SELECTED AMOUNT MUST BE GREATER THEN RECEIPT TOTAL==הסכום הנבחר חייב להיות מתאים לסה"כ של קבלה
SUPPLIER DOCKET LINE IS MISSING OR MISTAKEN!==! שורת תעודת ספק חסרה או לא תקינה
CALC MIX==חישוב
SAVE NEW PLANT SPECIFIC COST?==? לשמור מחיר חדש למפעל הספציפי הזה
NOT IN THE LIST==לא ברשימה
CUSTOMER/JOB SITE NOT DEFINED !==! לא מוגדר אתר הלקוח
BVR HSRV==תוכנית תקשורת מרכזית
GRP_ACTIVATE==פעילויות
PERFORM TIMERS==ביצוע תזמונים
IMPOR/EXPORT==יצוא/יבוא
FILES TO IMPORT==קבצים לקליטה
BROADCAST==קבצים לשידור
LBL_FILE_NAME==נקלט אחרון
MODIFY_GROUP==קבוצת עדכון
DELETE_GROUP==קבוצת מחיקה
MNG ITEMS==פריטים
ADDITION CODE IS MISSING==חסר קוד תוספת
TECH ADDITIONAL CODE IS MISSING==חסר קוד תוספת טכנית
OPERATION IS NOT ALLOWED==אין אפשרות לביצוע הפעולה
CUST_ADDITIONS==תוספות ללקוח
RECORD ALLREDY EXIST IN VALUES==הרשומות כבר מכילות ערכים
TRAN_ADDITIONS==תוספות למוביל
SHD_DRIVER==נהג
TOTAL_AMOUNT==סה"כ סכום
INV_REMARK==הערה לחשבונית
REMARK_1==הערה 1
REMARK_2==הערה 2
SHD_TRUCK==משאית
TRUCK IDENTIFICATION==זהוי משאית
FOR COMPANY TRUCKS ENTER THE TRUCK NUMBER==* למשאיות של החברה תשתמש בקוד משאית
FOR EXTERNAL TRUCKS ENTER THE LICENSE PLATE NUMBER==** למשאיות חיצוניות תשתמש במספר רישוי
TRUCK ID :==קוד משאית
TRUCK PLATE NUMBER  :==מספר רישוי
TRUCK DOES NOT EXIST==המשאית לא קיימת
DELETE THE PHIS_SILO ?==!? למחוק את הסילו
CAN NOT DELETE THE TITLE==! לא ניתן למחוק את הכותרת
DELETE RAW MAT==למחוק חומר מס'
PRICE ALLREADY EXISTS FOR THIS BRANCH AND ITEM==! המחיר לפריט זה כבר קיים
CHANGE ITEM==שינוי פריט
ABORT WEIGHTING OPERATION==ביטול שקילה
ABORT WEIGHTING PROCESS ?!==? לבטל ביצוע שקילה
WEIGHTING OPERATION ABORTED==! ביצוע שקילה בוטל
WEIGHT IS OVER MAX TRUCK S WEIGHT ! CONTINUE?==? המשקל גבוה ממשקל מקסימאלי של המשאית ! האם להמשיך
NO PREVIOUS TICKET FOR THIS TRUCK==אין תעודות בהמתנה למשאית הזאת
GET TRUCK FEATURES==קבלת אפיון משאית
EXPORT TRN TABLE==יצוא טבלאות משתמש
EXPORT VALUES TRN TABLE==יצוא ערכי טבלאות משתמש
EXECUTING SQL OPERATIONS==ביצוע פעולות SQL
INCORRECT BATCH OPERATION==פעולת הפעלה שגויה
SELECT DATE==בחר תאריך
DELETE SUPPLIER DOCKET==מחיקת תעודת ספק
ARE YOU SURE YOU WANT TO DELETE THIS SUPPLIER DOCKET?==? אתה בטוח שברצונך למחוק את התעודת ספק הזאת
THIS SUPPLIER DOCKET IS NOT UPDATABLE!==! תעודת ספק הזאת לא נתנת לעדכון
TRUCK_STATUS==סטאטוס משאית
WALKIN CODE==קוד לקוח מזדמן
DESTINATIONS==יעדים
MODIFIED==עבר שינוי
ADDRESS AND DISTANCES==כתובות ומרחקים
EAST COORDINATE==מיקום מזרחי
NORTH COORDINATE==מיקום צפוני
STATE/COUNTRY==מדינה
GENERAL INFO.==מידע כללי
ALLOW DESTINATIONS==לאפשר הגדרת יעדים
SITE CODE AND DESCRIPTION==קוד ושם האתר
UNCONNECTED BALANCE==מאזן לא מחובר
PAY. TERMS==תנאי תשלום
INDEX PERCENTAGE==אחוז מדד
0 IS AN ILLEGAL CONTRACT ID==ערך 0 לא אפשרי לקוד הסכם
PLANT MAPPING/PRINT DEF.==הגדרות שיטת הדפסה למפעל
PLANT BATCH BOOK LINKAGE==קישור ספר אב למפעל
GRADATION DATA ENTRY==הכנסת נתוני דירוג
GRADATION TYPES==סוגי דירוג
MIX RECIPES REPORTS==דוחות תערובות
ACCOUNTING TRANSACTIONS==פקודות יומן
ARRANGE DETAILS FIELDS POSITIONS==סידור מיקום פרטי שדות
FIRST_CITY_CODE==קוד עיר ראשונה
LAST_CITY_CODE==קוד עיר אחרונה
ACTUAL DIST.==מרחק ריאלי
DRIVING DIRECTIONS==הנחיות לנהיגה
SITE  AND DESTINATION==אתר ויעד
NEW  GROUP==הוספה
SPECIFICATION==מפרט
ALIAS==כינוי
CUST CODE==קוד לקוח
CUST NAME==שם לקוח
ITEM MODIFIED DESCRIPTION==תיאור שינוי פריט
ATTEMPT FOR EMPTY RECORD, CLICK ON THE ITEM CODE CELL IN THE NEW RECORD ROW==השורה החדשה כבר נפתחה, יש להכניס נתונים
SELECT BY ALIAS==בחר לפי כינוי
TAX CODE DESCRIPTION==תיאור קוד מס
SPECIFICATION TABLE==טבלת מפרט
NEW GENERAL PRICE LIST==רשימת מחירים כללית חדשה
REPORT==דו"ח
RAW MATERIAL SELECTION==בחירת חומרי גלם
PHYSICAL SILO==סילו פיזי
CONVERTED ITEM==פריט שהוחלף
SUPP. DOCKET NUMBER==מספר תעודת ספק
DOCKET DATE AND TIME==תאריך ושעת תעודה
RECEIVING PLANT==מפעל מקבל
MIX RECIPE==מתכון
VER.==גרסה
REMOVE ICON ?==? בלטל איקונין
CURRENCY DETAILS==פרטי מטבע
WASH OUT TIME (SECONDS)==זמן הרחיצת משאית באתר
MAX. LOAD SIZE==מקס. להעמסה
STORE TRIP TIME HISTORY FOR EACH DESTINATION==שמירת היסטורית זמן נסיעות לאתר
INCOMING MAT.==תעודות ספקים
MAX TIME FOR RETURN==זמן לבטון חוזר
QNY PER UOM==כמות לכל יחידה
GROUP TYPE==סוג קבוצה
TRANS. GRP  CUSTOMER==קבוצת הובלה ללקוח
TRANS. GRP. - TRANSPORTER==קבוצת הובלה למוביל
TRANSPORTATION GROUP - CUSTOMER==קבוצת הובלה ללקוח
TRANS GRP CUST CODE DESCRIPTION==תיאור קבוצת הובלה ללקוח
TRANSPORTATION GROUP - TRANSPORTER==קבוצת הובלה למוביל
TRANSPORTATION GROUP - HAULER==קבוצת הובלה למוביל
ACCOUNT CAN NOT BE DELETED DUE TO DATA IN THE SYSTEM==לא ניתן למחוק לקוח/ספק ללא הרשאה הנכונה
EXPIRY DATE RANGE==טווח מועד סיום
EXPIRY DATE==מועד סיום
QUERY NOT CREATED==השאילתה לא נבנת
BASE CONT==הסכם בסיס
DISC TYPE==*
TRUCKS/DRIVERS SCHEDULE==תכנון משאיות/נהגים
SCHEDULE ?==? לתכנן
SCHEDULE==תכנון
HOURS==שעות
SCHEDULED TRUCKS==משאיות בתכנון
AVAILABLE TRUCKS==משאיות זמינות
SHIP DOCK. PRINT FORMAT AND PLANT MAPPING==מבנה הדפסת תעודות ומיפוי למפעלים
PRINT FORMATS DEFINITION==הגדרת מבני הדפסת תעודות
ITEM GROUP TYPES==סוגי קבוצות פריטים
PLANT MAPPING==מיפוי מפעל
PHYSICAL PLANT==מפעל פיזי
PLANT MAPPING DETAILS==פרטי מיפוי מפעל
LOGICAL PLANT==מפעל לוגי
ITEM GROUP TYPE==סוג קבוצת פריטים
PRINTER #==מדפסת
PRINT FORMAT DEFINITION==הגדרת מבנה הדפסה
NO ITEM GROUP TYPE FOUND==לא נמצא סוג קבוצת פריטים
INV. REF. #==מספר
INV. REF. BR. #==מספר סניף
PLANT DESC.==תיאור מפעל
ITEM DESC.==תיאור פריט
PHONE #==טלפון
FAX #==פקס
STATE / COUNTRY==מדינה
TRANSPORTATION CONTRACT==הסכם הובלה
CUSTOMERS COMPLAINTS==תלונות לקוחות
COMPLAINTS LIST==רשימת תלונות
CBX_ACTIVE==*
COMPLAINT ID==מס' תלונה
CONTACT==מגע
QCS SAMPLE ORDER==הזמנת מדגם איכות
QCS SAMPLE==מדגם איכות
COMPLAINT DETAIS==פרטי תלונה
CONTACTS LIST==רשימת מגעים
STATUS CHANGES==שינוי סטאטוס
(AS APEARS ON THE TICKET)==כפי שמופיע בתעודה
ENTRY UOM==תקליד יחידה
ENTER THE ACTUAL QTY AS PRINTED ON THE TICKET, ANY CONVESION NEEDED WILL BE DONE BY THE SYSTEM.==*
MODIFICATION RULES==כרטיס
MODIFICATIONS RULES SET==כרטיס הפעלות
DOUBLE CLICK ON THE GRID TO LOCATE THE FIRST TRUCK FOR THE ORDER==*
ORDERED ITEM==הפריט שהוזמן
ITEM ALIAS==כינוי פריט
PROD_QNT==כמות ליצור
S.UOM==יחידה
MIRROR SITE==אתר לחיקוי
DISTANCE CODE==קוד מרחק
S/C==מדינה
CUSTOMER /JOB SITE / DESTINATION==לקוח/אתר/יעד
PRODUCTION DEFINITIONS==הגדרת יצור
TRIM WATER==הפחתת מים
ADD_WATER==מים באתר
REQ. PLANT==מפעל ההזמנה
PRICING DEFINITIONS==הגדרת תמחור
PRICING PLANT==מפעל תמחור
POURING METHOD==שיטת יציקה
ADDITIONAL INFORMATION==מידע נוסף
AUTO DISPATCH==שליחה אוט. להעמסה
ONLY ASSIGNED TRUCKS==רק משאיות מוקצות
REF #==מספר
ORDERED BY==הוזמן ע"י
CURRENT QTY.==כמות נוכחית
TERMINATE==סיום
DATE/TIME==תאריך/שעה
ORDER REMARKS==הערות להזמנה
LEAVE JOB SITE==עזיבת האתר
ARRIVE ON JOB SITE==הגעה לאתר
WATER ADDED ON SITE==הוספו מים באתר
VOID DETAILS==פרטי ביטול
VOID==ביטול
VOID REASON==סיבת ביטול
VOID REASON CODE==קוד סיבת ביטול
CREDIT REASON==סיבת זיכוי חלקי
CREDIT REASON CODE==קוד סיבת זיכוי
CUSTOMER AND DESTINATION DETAILS==פרטי לקוח והיעד
WATER - REQUEST==מים בהזמנה
TRIM==הפחתה
WATER - PRODUCTION==מים ליצור
PRODUCED ITEM SELECTION==פריט ליצור
REQ. QTY==כמות
PROD. QTY==כמות ליצור
START BATCH==תחילת העמסה
LEAVE PLANT==עזיבת מפעל
ARRIVE ON SITE==הגעה לאתר
BATCH NOW==יצר עכשיו
THIS LOAD WILL ARRIVE TOO LATE==התעודה תסופק באיחור
BOOK==ספר
DENSITY_FACTOR==*
RATIO_MUL==*
RATIO_DIV==*
OPEN==פתיחה
USERS MANAGEMENT==ניהול משתמשים
ALL RIGHTS==כל ההרשאות
USER TABLE MENU==תפריט טבלאות משתמש
GROUP RIGHTS==הרשאות קבוצה
GROUP TABLES MENU==תפריט טבלאות קבוצת משתמשים
SYSTEM RIGHTS==הרשאות המערכת
AVAILABLE  FIELDS==שדות זמנים
CUSTOMER OUT OF CREDIT==הלקוח עבר את גובה אשראי
CONTRACT NOT FOUND IN DATABASE==ההסכם לא קיים בנתונים
QTY MUST BE A NUMERIC VALUE==כמות חייבת להיות מגדרת במספרים
CONTRACT IS NOT APPROVED FOR SUPPLY==ההסכם לא מאושר להספקה
LOCAL BRANCH==סניף מקומי
PRINT QUOTE FORM==הדפסה
EFFECTIVE FROM==מתאריך
PATH==נתיב
ENTER ACCOUNT # OR THE FIRST LETTERS OF THE ACCOUNT NAME, OR * FOLLOWED BY A PART OF THE ACCOUNT NAME, HIT TAB FOR SELECTION==רשום מספר לקוח או אותיות ראשונות של שם לקוח או חלק משם לקוח עם סימון שדה "אמצע מילה", הקיש על כפטור "TAB" במקלדת כדי לבמע חיפוש
CREATE NEW==צור חדש
CREDIT CARD DETAILS==פרטי כרטיס אשראי
CARD PIN==מס' ביקורת
CARD EXP DATE==תאריך תוקף
INVOICE &DETAILS==פרטי חשבונית
LINES DE&TAILS==פרטי שורות חשבונית
PRINT DEPOSIT==הדפס הפקדה
PRINT RECEIPT==הדפס קבלה
LINK==קישור
COMPANY # MUST BE ENTERED==!שדה חברה חובה
REAL UOM==יחידה ריאלית
PLANT IS MISSING!==!חסר מספר מפעל
SUPPLIER IS MISSING!==!חסר מספר ספק
SUPPLIER PLANT IS MISSING!==!חסר מפעל ספק
TICKET NUMBER IS MISSING!==!חסר מספר תעודה
INVALID FLOAT NUMBER==כמות לא נכונה
QUANTITY MUST HAVE A VALUE==!שדה כמות חובה
EXCEL F.NAME==EXCEL קובץ
SEL==*
^^^^^==ריק
NO COMMUNICATION WITH HEAD OFFICE - CHECK NETWORK CONNECTION==.אין תקשורת למשרד הראשי! תבדוק חיבורי רשת
NO TRUCK WAS FOUND==לא נמצאו משאיות
CUST. CODE==קוד לקוח
STATUS_DESC==תיאור סטאטוס
CREATING NEW ORDER==הקמת הזמנה חדשה
SEARCH STRING==שדה חיפוש
MANAGE ITEMS==ניהול פריטים
GRADATION TYPE==סוג דירוג
DISP.==סדרן
MODIFICATION STATUS==שינוי סטאטוס
INCLUDE NEW ORDER==להכיל הזמנה חדשה
TIME FRAME==מסגרת זמן
SCHEDULED TRUCKS ONLY==משאיות מתוכננות בלבד
ORDERS RANGE DEFINITION==הגדרת טווח הזמנות
DEMAND GRAPHS==דרישת תרשימים
TRUCK SCHEDULE==תכנון משאית
CURR. DISPATCHER==סדרן נוכחי
DEF. SCHEDULE==הגדרת תכנון
CLICK TO SCHEDULE THE TRUCK AND THE DRIVER FOR THE DEFAULT SHIFT LENGTH.==*
OTHER DISPATCHERS==סדרנים נוספים
REMOVE FROM SCHEDULE==להוריד מתכנון
SAVE TRUCKS SCHEDULE==שמור תכנון משאיות
REQUIRED TRUCKS==משאיות נדרשות
PHYSICAL SILOS==סילואים פיזים
DB CODE==קוד בסיס נתונים
GROUPS ROOT==שורש קבוצות
ROOT UPDATE==עדכון השורש
NEXT KEY LEN==אורך קוד הבא
FROM TABLE==מטבלה
TO TABLE==עד טבלה
< TO VIEW TABLES DOUBLE CLICK==לחיצה כפולה על השדה תציג רשימת טבלאות
PLEASE FILL ALL THEN NECCESSARY FIELDS==נא למלא את כל השדות ההכרחים
INVALID DATA IN QTY==נתון שגוי בשדה של כמות
PRODUCT COST==עלות מוצר
STATEMENT==כרטיס לקוח
CHECK FOR CASE SENSITIVE SEARCH==רגיש להבדל בין אותיות
MIN. QTY==כמות מינימאלית
SHORT LOAD COST==עלות הובלה חלקית לכל קוב חסר
MIN. QTY.==כמות מינימאלית
NO PREVIOUS DELIVERY==אין העמסות קודמות
DISCONNECT==ניתוק
BALANCE TABLE NOT DEFINED==טבלת כרטיס לקוח לא הוגדרה
NEW ORDER ITEM CAN NOT BE REPLACED BY THE SHIP DOCK ITEM==הפריט בהזמנה חדשה לא יכול להיות מוחלף בפריט הנבחר
ALTERNATE DESCRIPTION==תיאור חליפי
SHORT ALTERNATE DESCRIPTION==תיאור קצר חליפי
PRICE &HISTORY==היסטורית מחירים
&ADDITIONS==תוספות
X==*
DELETE CURRENT LOAD REQUEST ?==? למחוק את בקשת העמסה הנוכחית
CLICK TO TRANSFER THE TRUCK TO ANOTHER PLANT==לחץ כדי להעביר את המשאית למפעל אחר
COMM. STATUS OK==תקשורת לשרת המרכזי תקינה
CE_HSRV RESPONDING==יש תגובה מתוכנית תקשורת המרכזית
UNLINK INVOICE==ניתוק חשבונית
UNLINK RECEIPT==ניתוק קבלה
UNLINK DEPOSIT==ניתוק הפקדה
CONTRACT ACTIVE VER DATE==גרסה פעילה של ההסכם
ACTIVE VER==גרסה פעילה
LAST MODIFY DATE==תאריך עדכון אחרון
INDEX  PERCENTAGE==אחוז ממדד
AUTO INDEX==מדד אוטומטי
PRICE INCLUDES VAT==המחיר כולל מע"מ
ITEM BRANCH==סניף/מפעל לפריט
ITEM PAYMENT TERMS==תנאיי תשלום לפריט
ITEM DISCOUNT TYPE==סוג הנחה לפריט
ITEM BASE CONTRACT==הסכם בסיס לפריט
MINIMUM DAILY QTY.==כמות יומית מינימאלית
NO MIX WAS FOUND FOR THIS ITEM, THE ORDER WILL BE CREATED AS AN INACTIVE ORDER==לא קיימת תערובת לפריט הנבחר! ההזמנה תוקם בסטאטוס המתנה לאישור ברשימת הזמנות הכללית
PLANT SERVICES==תקשורת למרכז החברה
LAST RCVD FILE==האחרון שנקלט
LAST XMTED FILE==האחרון שנשלח
RCVD PACKETS==פקטים נקלטו
0==*
TRANSMITTED PACKETS==פקטים נשלחו
FTP_STATUS==סטאטוס FTP
LBL_FTP_OPER==>
LB_SHD_TIMER_STATUS==>
LB_ACTIVATE_ORDER_STATUS==>
REMOTE APPLICATION SERVER STATUS==מצב התחברות עם שרת תקשורת המרכזי
COMMUNICATION STATUS==מצב תקשורת
XMT STACK==קבצים בשליחה
RCV STACK==קבצים בקליטה
TIMER==תזמון
FTP==FTP
TIME OUT FOR COMMUNICATION WITH THE CONTROLLER==אין תקשורת עם בקר! תבדוק פעילות של תוכנית התחברות לבקר
GROUP_NAME==שם קבוצה
RAW_MATERIAL==חומר גלם
THIS ENTRY DOCKET WAS ALREADY RECEIVED!==התעודה כבר קיימת במערכת
ABBR==תיאור קצר
IS_VOLUME_UNIT==יחדה נפחית
DENSITY_VOLUME_UNIT==צפיפות נפח יחידה
DENSITY_WEIGH_UNIT==צפיפות משקל יחידה
DISPLAY_WEIGH_UNIT==תצוגת משקל יחידה
PRINT DOC.==הדפסת תעודה
QTY MUST BE LESS THAN OR EQUAL TO TRUCK MAX WEIGHT==הכמות חייבת להיות זהה או קטנה מנפח המשאית
QTY MUST BE LESS THAN OR EQUEL TO TRUCK MAX WEIGHT==הכמות חייבת להיות זהה או קטנה מנפח המשאית
BOOK EXIST !==! מספר ספר אב כבר קיים
PRINT TICKET==הדפסת תעודה
CHECK CONTINUITY==בדיקת רצף
MINIMUM DEFINITION==הגדרת מינימום
MAXIMUM DEFINITION==הגדרת מקסימום
COMP. TYPE==*
ALLOW INPUT==הרשאת קלט
SORT FIELDS==מיון שדות
CONTINUITY CHECK RESULTS==תוצאות בדיקת רצף
CONTINUITY CHECK WAS NOT PERFORMED==בדיקת רצף לא הצליחה
QUERY BY FORM DEFINITION FOR :==ביצוע שאילתות עבור -
ALL INPUT TYPES==כל סוגי קלט
- DESCRIPTION== - תיאור
REPORT MANAGEMENT FOR :==רשימת דוחות עבור -
DESIGN SCREEN==תכנון מסך
CANCEL DESIGN GRID==ביטול תכנון רשומות
CONFIRM GRID DESIGN==אישור תכנון רשומות
DESIGN UPDATE/DETAILS==תכנון פרטי רשומות
CANCEL DESIGN UPDATE/DETAILS==ביטול תכנון פרטי רשומות
CONFIRM DETAILS DESIGN==אישור תכנון פרטי רשומות
DRAG MODE==מצב גרירה
ALIGN==יישור
DESIGN VALUES==תכנון ערכים
DESIGN TABLE/SQL==תכנון טבלה/SQL
DATA TRAILERS ARE NOT DEFINED FOR THIS OBJECT==לא מוגדרים נתונים נגררים עבור האובייקט
SHIP DOCKET IS ALLREADY CONNECTED TO AN INVOICE==התעודה כבר מקושרת לחשבונית
SHIP DOCKET IS ALLREADY CANCELED==התעודה כבר בוטלה
BMG SELTEC SYSTEM DESIGNER==מחולל המערכת
NO MIX WAS FOUND FOR THIS ITEM, THE ORDER WILL BE CREATED AS AN INACTIVE ORDER. CREATE ORDER?==?לא נמצאה תערובת לפריט הנבחר, ההזמנה תוקם בסטאטוס - אישור טכני. האם להקים הזמנה
DISTANCE UNITS==יחידת מרחק
CUBIC METERS==מ"ק
PRINTER NOT FOUND==לא מוצא מדפסת
OPTIMIZE==תכנון
TOTAL WEIGHT==משקל כולל
MIX DESIGN==תכנון תערובת
%/AGG.==% אגר.
ENTER THE DENSITY OF THE MATERIAL==נא להגדיר את הצפיפות של החומר
RAW MATERIAL QUANTITY IN HIGHER THEN MAX ENTRY ALLOWED!==! הכמות גדולה מכמות מקסימאלית בסילו
DECISION==החלטה
DELETE DEPOSIT==מחיקת הפקדה
ARE YOU SURE YOU WANT TO DELETE THIS DEPOSIT?==? אתה בטוח שברצונך למחוק את ההפקדה
DEPOSIT DELETED==ההפקדה בוטלה
MATERIAL==חומר גלם
TRUCK IS IN USE!==המשאית כבר בשימוש
SHIP DOCK CAN NOT BE CHANGED==התעודה לא ניתנת לשינוי
CONNECTION WITH HEAD OFFICE FAILED- CHECK NETWORK CONNECTION==אין תקשורת עם המשרד הראשי! בדוק תקינות הרשת
WAITING FOR BATCH CONTROLLER RESPONSE==ממתין לתשובה מבקר יצור
CLICK THIS BUTTON TO  RETURN THE LOAD REQUEST TO THE ORIGINAL DISPATCHER==תלחץ על הכפתור כדי להחזיר את כל התעודות לסדרן
UL AUTO. TRANSFER==*
MISSING RIGHT QUOTE==בעיה בהגדרת משאית - פנה למרכז החברה
FOLLOW UP PERIOD==תקופה למעקב
RELATION DESCRIPTION==תיאור קירבה
OFFICE #==משרד
HOME #==בית
CONTACT PERSON  NAME==שם איש הקשר
ITEM ACCOUNTS DEFINITIONS==הגדרת חשבונות לפריט
ACTIVE TRUCKS==משאיות פעילות
PRINT FORMAT TYPES==סוגי תבניות הדפסה
FRINT FORMAT==תבנית הדפסה
ACTIVATE PRICE BATCH MODIFICATION==הפעלת תוכנית התייקרות
SELECT THE BATCH MODIFICATION TO BE ACTIVATED==בחר התייקרות להפעלה
ARE YOU SURE YOU WANT TO DELETE THE QBF RECORD ?==? ברצונך למחוק את השאילתה
PRICE BATCH MODIFICATIONS LIST==רשימת התייקרויות
CHECK ONE OF THE OPTION TO DEFINE  AMOUNT MODIFICATION OF PERCENTAGE MODIFICATION==*
MODIF. TYPE==סוג התייקרות
CUSTOMER BLOCKED FOR SUPPLY==הלקוח חסום להספקה
NUMERIC VALUE REQUIRED==נדרש ערך מספרי
CONTACT PERSON  DETAILS==פרטי איש קשר
MOBILE #==מס' נייד
COMPLAIT ID==*
COMPLAINT DATE==תאריך תלונה
QTY. START==כמות התחלתית
QTY. USED==כמות יצא
QTY. ENTRY==כמות נכנסה
MEASURED QTY.==כמות נמדדה
SOURCE EXIST==*
CUSTOMER NOT SELECTED==לא נבחר לקוח
RETURN CURRENT LOAD REQUEST==החזרת בקשת העמסה האחרונה
WRONG SILO/STOCK PILE NUMBER==סילו לא נכון
INVALID OR NO QUANTITY ENTERED==ערך לא נכון או חסר
ACCOUNTING LINES FOR EXPORT==*
DEST. ZONE==איזור
DEST. STATUS==סטאטוס
DESTINATION NUM==מספר
DESTINATION DESCRIPTION==תיאור
INVALID NUMBER RANGE==מספר שגוי בדשות
PLANT RANGE IS EMPTY==שדות מפעלים ריקים
TABLE#==מספר טבלה
TRUCK # IS MISSING==חסר מספר משאית
CONNECTION FAILED !==! התחברות נכשלה
CONNECTION OK !==! התחברות הצליחה
CAN NOT SORT BY THE REQUIRED FIELD==לא ניתן למיין לפי שדה המבוקש
SELECT JOB SITE==בחר אתר
JOB SITE #==מספר אתר
JOB SITE NAME==שם אתר
CUSTOMER SEARCH==חיפוש לקוח
JOB SITE NAME SEARCH==חיפוש שם אתר
TIME FRAME DEFINITIONS==הגדרת זמן פעילות
AAD_ADDITION_CODE==קוד תוספת
AAD_ADDITION_TYPE==סוג תוספת
AAD_FROM_PLANT==ממפעל
AAD_TO_PLANT==עד מפעל
AAD_FROM_ZONE==מאזור
AAD_TO_ZONE==עד אזור
AAD_PERIOD_ID==קוד תקופה/זמן פעילות
AAD_ADDITION_QNT==כמות ההפעלה
AAD_ADDITION_DESC==תיאור תוספת
TIME_FRAMES==זמן פעילות
TFD_PRD_ID==קוד תקופה
TFD_ID==קוד פעילות
TFD_DESCRIPTION==תיאור
TFD_STRAT_MONTH==מחודש
TFD_START_DAY==מיום
TFD_END_MONTH==עד חודש
TFD_END_DAY==עד יום
TFD_START_TIME==משעה
TFD_END_TIME==עד שעה
TFD_START_PERIOD==תקופת התחלה
TFD_END_PERIOD==תקופת סיום
TFD_SUN_ACTIVE==יום ראשון
TFD_MON_ACTIVE==יום שני
TFD_TUE_ACTIVE==יום שלישי
TFD_WED_ACTIVE==יום רביעי
TFD_THU_ACTIVE==יום חמישי
TFD_FRI_ACTIVE==יום שישי
TFD_SAT_ACTIVE==שבת
TFD_PERIOD_CODE==תקופה
PLEASE ENTER CONTRACT NO==נא להקליד מספר הסכם
QTY MUST BE HIGHER THEN 0==כמות צריכה להיות גבוהה מ-0
CAD_CONTRACT_ID==הסכם
CAD_ADDITION_CODE==קוד תוספת
CAD_ADDITION_QNT==כמות תוספת
CAD_ADDITION_DESC==תיאור תוספת
B.BOOK CODE==ספר אב
BATCH BOOK DESC.==תיאור
MESSAGE==הודעה
DONE / RESPOND==בוצע
STOCK READING CAN NOT BE BEFORE LAST READING==ספירת מלאי לא יכולה להתבצע מוקדם יותר מהספירה האחרונה! בדוק את התאריכים
INVOICE TYPE==סוג חשבונית
FROM INV #==מחשבונית
TO INV #==עד חשבונית
PRINT CONTRACT==הדפסת הסכם
PRINT_TBL==טבלת הדפסה
PRINT_TBL_2==טבלת הדפסה 2
PRINT_TBL_3==טבלת הדפסה 3
TAX EXEMPT.==פטור ממס
TAX EXEMPTIONS==פטור ממס
EXEMPTION CODE AND EXPIRY DATE==קוד הפטור ומועד סיום
EXEMPTION CODE==קוד הפטור
MIRROR_SITE==אתר לחיקוי
VAT_CODE==מע"מ
MAX_LOAD_SIZE==כמות מקסימום
DEF_LOAD_SIZE==*
SELECT DETAILS INPUT TYPE==*
SELECT DATABASE==בחר בסיס נתונים
&CREATE LIKE==העתקה
HOT SPOTS==GPS
HOT SPOT TYPE==סוג מיקום
LATITUDE==קו-רוחב
LONGITUDE==קו-אורך
LAT. OFFSET==פיצוי קו-רוחב
LON. OFFSET==פיצוי קו-אורך
GEO FENCES DEFINITION==הדגרת מיקום גיאוגרפי
SAVE GEO FENCES==שמור מיקום גיאוגרפי
GRID PREFERENCE==עדיפות רשת
NMEA (DDDMM.MMMM)==*
DECIMAL DEGREES (DDD.DDDDDD)==מעלות עשרוניות (DDD.DDDDDD)
DEGREES (DDD,MM,SS.SS)==מעלות (DDD,MM,SS.SS)
SAVE GRID PREFERENCE==שמור עדיפות רשת
LAT==קו-רוחב
NORTH==צפון
SOUTH==דרום
LONG==קו-אורך
EAST==מזרח
WEST==מערב
*==*
-==*
SET TAX EXEMPTIONS==קביעת פטור ממס
DATA IS MISSING, CAN NOT PERFORM QUERY, DO YOU WANT TO VIEW THE SQL SYNTAX?==? חסרים נתונים, השאילתה לא מצליחה לרוץ, האם תרצה לעיין בה
GEO FENCES==מיקום גיאוגרפי
SHOW MIX==תערובת
* MANUALLY ADDED MATERIALS==* חומרים להוספה ידנית
MIX QTY==כמות לקוב
UOM==יחידה
BATCH UOM==יחידה להעמסה
REUTRN CURRENT LOAD REQUEST ?==? להחזיר בקשת העמסה
REPLACE==החלפה
DIST./DRIVING DIRECTION==הנחיות נהיגה
CUSTOMER STATUS==סטאטוס לקוח
HAULER DISTANCE==טווח למוביל
WRONG TAX DEFINITION==הגדרת מע"מ לא נכונה
...==*
ST==*
LOGICAL OP.==*
XXX==*
%==*
?==*
ORDER ENTRY==הכנסת הזמנה
DEFAULT PRICING==תמחור ברירת מחדל
JOB DATA==פרטי אתר
MENU INI VALUES==ערכי קובץ הגדרות לתפריט
SPECIFIC INI VALUES==ערכי קובץ הגדרות
SECTION==סעיף
INI SECTION==סעיף
INI ITEM==פריט
INI VALUE==ערך
SPECIFIC INI VALUES FOR MENU==קובץ הגדרות לתפריט
DESICION==*
UPDATE RECEIPT==עדכון קבלה
CONTINUE TO TABLE DESIGNER?==? להמשיך לתכנון טבלה
CE-INVOICE-CREDIT==*
WAITING FOR WEIGHING TO START==ממתין לתחילת שקילה
END OF LOAD==סיום העמסה
SECURITY==אבטחה
USER INI VALUES==למשתמש INI
LINE NR==מס' שורה
SECURITY PROFILES==פרופילי אבטחה
PROFILE NR.==מס' פרופיל
PROFILE DESCRIPTION==תחאור פרופיל
SELECTION TABLE==טבלת בחירה
SELECTION TABLE DESCRIPTION==תיאור טבלת בחירה
CODE FIELD NAME==קוד שדה
DESCRIPTION FIELD NAME==תיאור שדה
MENU==תפריט
SPECIFIC INI VALUES FOR USER==קובץ הגדרות למשתמש
CURR. DESCRIPTION==תיאור מטבע
ACCOUNT #==חשבון
ACCOUNT DESCRIPTION==תיאור חשבון
FROM ZONE==מאזור
TO ZONE==עד אזור
FROM LAB==ממעבדה
TO LAB==עד מעבדה
SHKIA==שקיעה
ID EXIST==הקוד כבר קיים
DELETE BATCH OPERATION==מחיקת פעולת אצווה
OPERATION LINE EXIST CONTINUE ?==? שורת פעולה כבר קיימת, להמשיך
DATA IS MISSING, CAN NOT PERFORM QUERY==חסרים נתונים! לא ניתן להמשיך את השאילתה
CONFIRM RECALCULATION , MAY TAKE A FEW MINUTES==חישוב מחדש יכול לקחת מספר דקות
TRUCK IS IN USE, CREATE LOAD REQUEST?==?המשאית כבר בשימוש. להקים בקשת העמסה בכל זאת
MIX DESIGNS REPORTS==דוחות תכנון תערובות
BATCH BOOK #==מס' ספר אב
BASE ITEM CODE==קוד פריט בסיסי
VER #=='גרסה מס
VER DATE/TIME==תאריך גרסה
BATCHED RAW MATERIAL==העמסה לפי חומר
SELECT A RAW MATERIAL WHEN THE BATCHED MATERIAL DIFFERS FROM THE MATERILA IN THE MIX DESIGN==*
LINK TO ACC.==בנה פקודה
MAX_DAYS_BACK==מקס. ימי פירעון אחורה
CREDIT QTY==כמות לזיכוי
CREATE NEW ACCOUNTING TRNANZACTION ?==? לבנות פקודת יומן חדשה
CREDIT DETAILS==פרטי זיכוי
CREDIT TRASNPORTATION==זיכוי הובלה
WAIT TIME (MINUTES)==זמן המתנה בדקות
SHORT LOAD (UNITS)==הוב' חלקית מ"ק
RETURNED==חוזר
CE_RD==סידור מרכזי
REGIONAL DISPATCHER==סידור מרכזי
LOCAL ORDERS==הזמנות מקומיות
UPDATE ORDER==עדכון הזמנה
RETURNED LOAD REQUESTS==דרישות העמסה חוזרת
CURR. QTY==כמות נוכחית
NEXT SUPPLY==הספקה הבאה
REGIONAL DISPATCHER AT :==סידור מרכזי
TRIP TIME IS NOT DEFINED, CONTINUE WITH ORDER?==?זמן נסיעה לא מוגדר, להמשיך להקים הזמנה
VIEW ALL==הצג הכל
WAITING TO END WEIGHING==ממתין לסיום שקילה
ANOTHER PROCESS IS ACTIVE==תהליך אחר בפעולה
THIS BUTTON WILL EXECUTE THE BATCH OPERATION # (INI:ACCOUNTING/EXP_TYPE) WITH COMPANY# & TRAN# AS PARAMS.==*
INCORRECT NO==מספר לא נכון
MONITOR HEARTBEAT==פעימות המוניטור
STOP BEEP==עצירת ציפצוף
CAN NOT ISSUE RECEIPT TO CURRENT INVOICE==לא ניתן להפיק קבלה לחשבונית הנדרשת
UPDATE PRICE LIST==עדכון מחירים
SELECTED CONTRACT IS NOT IN AN ACTIVE STATUS==ההסכם הנבחר לא בסטאטוס פעיל
GPS CODE==GPS קוד
GPS UNIT CODE==GPS קוד יחידת
LOCATION PROVIDER CODE==קוד ספק מקומי
ACCEPT?==? מסכים
PAYMENT TYPE NOT SELECTED==לא נבחר סוג תשלום
DELETE THE PHISICAL SILO ?==? למחוק סילו פיזי
DEFAULT PRICE IS MISSING==חסר מחיר ברירת מחדל
MAX ENTRY IS MISSING==כמות לכניסה מקסימאלית חסרה
NO HOT MATERIALS FOUND==לא נמצאו חומרים חמים
SELECTED DATE IS INVALID==התאריך שנבחר שגוי
THIS LINE ALREADY EXISTS==סוג תשלום זה כבר קיים
SUM_WEIGH==משקל מרחבי
SUM_WEIGH_CALC==משקל מרחבי מתוכנן
RATIO_W_C==יחס מים/צמנט
RATIO_W_C_CALC==יחס מים/צמנט מתוכנן
DB DEFINITION FILE NOT DEFINED==לא מוגדר קובץ הגדרות בסיס נתונים
SQL TRAN FILE NOT FOUND==קובץ תרגום SQL לא נמצא
CE_SCALE==תוכנית שקילה
CE SCALE==תוכנית שקילה
&STOCK==ניהול מלאי
THIS TRUCK CAN NOT SERVE THIS ORDER==המשאית לא יכולה להוביל להזמנה הזאת
CALC_PRICE==מחיר מחושב
CUSTOMER NOT FOUND IN DATABASE==הלקוח לא נמצא ברשימת הלקוחות
RAW_COST==עלות חומרים
SUM_EXTRA_PRICE==סיכום מחיר הוב חלקית
SUM_RAW_COST==סיכום עלות חומרי גלם
SUM_TRANS_COST==סיכום עלות הובלה
SUM_WAIT_COST==סיכום עלות המתנה
TOT_PRICE==סה"כ מחיר
TOT_COST==סה"כ עלות
KUB_PRICE==מחיר לקוב
KUB_COST==עלות לקוב
PROFIT==רווחנית
INVOICE NR.==מספר חשבונית
INV. BRANCH NR.==מקור חשבונית
ACCEPT==אשר
BRANCH NR.==מקור חשבונית
CLICK THE LABLE TO ALLOW ITEM ALIAS MODIDFICATION==*
LOCAL DISPATCHER NOT THE SAME AS SHIP DOCK DISPATCHER==לא ניתן לטפל בתעודה! הסדרן לא זהה לזה שהקים אתה
SUM_TRUCKS==סה"כ משאיות
TRUCK_NO==מספר משאית
TOTAL_PRICE==סה"כ מחיר
TOTAL_COST==סה"כ עלות
CALC_COST==עלות מחושבת
ITEM/MIX COST==עלות תערובת
PLANT NUMBER==מספר מפעל
BATCH BOOK NUMBER==מספר ספר אב
CALC DATE==תאריך חישוב
SHIP_DOCK==תעודה
SHIP_DOCKS==תעודות
RAW_CALC_PRICE==עלות חומר מחושבת
ITEM_PRICE_BASE==מחיר בסיס לפריט
DISPLAY AVAILABLE TRUCKS==הצגת משאיות זמינות
DISPLAY SCHEDULED TRUCKS==הצגת משאיות מתוכננות
DESTINATION CAN NOT BE CHANGED==יעד לא יכול להשתנות
INVALID WAITING PER UNIT==חסרה עלות ליחידה
REQ_ORDERS==הזמנות בתכנון
C_SHIP==תעודות
C_ITEM==פריטים
C_SITE==אתרים
C_INV==חשבוניות
TYPE IS MISSING==חסר סוג שדה
CLICK TO VIOD A LINE BY CREATING A DEBIT NOTE==להקים קבלה בנינוס על אותו סכום של שורת קבלה
VOID RECIEPT LINE==הקמת קבלה במינוס
CAN NOT BE VOIDED==לא ניתן לזכות
CONFIRM RECEIPT LINE VOID==המשך בניית קבלה במינוס
ARE YOU SURE YOU WANT TO VOID THIS RECEIPT LINE?==?את/ה בטוח/ה שברצונך להקים קבלה במינוס
NO_SITES==אתרים
NO_ITEMS==פריטים
THIS DEPOSIT LINE IS ALLREADY VOIDED==שורת הפקדה כבר זוכתה
PROJECTS==פרוייקטים
PROJECT==פרוייקט
THE SITE ZONE FOR PLANT SELECTION, 0 FOR NON ACTIVE SITES==איזור אתר עבור בחירת מפעל, 0 - לאתרים לא פעיל
THIS CODE IS USED BY THE CUSTOMER TP IDETIFY THE JOB SITE==*
PROJECT #==מס. פרוייקט
PROJECT DESCRIPTION==תיאור
PROJECT ZONE==אזור הפרוייקט
THE PROJECT ZONE FOR PLANT SELECTION, 0 FOR NON ACTIVE PROJECTS==איזור פרוייקט עבור בחירת מפעל, 0 - לפרוייקטים לא פעיל
PROJECT STATUS==סטאטוס הפרוייקט
PROJECT TYPE==סוג הפרוייקט
PROJECT CODE AND DESCRIPTION==קוד ותיאור פרוייקט
PRINT TRANS. CONTRACT==הדפסת הסכם
DELETE CURRENT LOAD REQUEST==מחיקת בקשת יצור
ATTENTION: PRODUCTION WAS STARTED==שים לב! היצור כבר התחיל
NOT MEMBER OF THE MODIFY GROUP==לא בקבוצת שינוי
NOT MEMEBR OF THE DELETE GROUP==לא בקבוצת מחיקה
NO CONTRACT NUMBER TO SAVE==אין מספר הסכם לשמירה
7_DAYS==7 ימים
28_DAYS==28 ימים
SMO_MEASUREMENTS==קוביות
SMO_SAMPLES==מדגמים
OPERATION TYPE IS MISSING OR MISTAKEN!==סוג תוכנית שגוי או חסר
JOB DEFINITION==*
JOB/SITE DESC.==*
WINNER==*
COMPANY DETAILS==פרטי חברה
GENERAL INFO==מידע כללי
CURR CODE==קוד מטבע
TRANS. CONTRACT==הסכם הובלה
CUSTOMERS==לקוחות
SELECT AS WINNER==*
CLICK TO SET THIS AS THE WINNER AAND TO CREATE A CONTRACT==*
ADDITIONAL INFO.==מידע על תוספת
QUOTES MANAGEMENT MODULE NOT INSTALLED==מודול הצעות לא מותקן במערכת
MIX PROPERTIES==תכנון תערובת
WATER/CEMENT==יחס מים/צמנט
W/C_RATIO==יחס מים/צמנט
AUTO - ONLY DOWNWARSDS==*
PREV. ORDERS==הזמנות קודמות
SPACING==תדירות
SELECTED PLANT==המפעל הנבחר
COMPANY_PC==מספר ח. פ.
TAX_FILE==תיק במ. הכנסה
SHD_TRUCK_CODE==ערבל
TRU_ACC_NO==קוד בהנה"ח
CONCRETE_QNT==בטון לפי תקן
MORTAR_QNT==טיט מוכן
BETKAL_QNT==בט-קל
MEDA_QNT==מדה בטון
BY_CAPACITY_QNT==לפי תכולת צמנט
BY_ORD_CUST_QNT==לפי דרישת לקוח
CEMENT_MORTAR_QNT==טיט צמנטי
FOAMING_CONC_QNT==בטון להקצפה
ORD_QNT==כמות שהוזמנה
SUP_QNT==כמות שסופקה
QTY ONBOARD:== כמות בטון חוזר-
MANUALLY ENTERED MATERIALS==חומרים להוספה ידנית
ENTER THE QUANTITIES  THAT WERE ADDED MANUALY TO THE BATCH==תקליד כמויות של חומרים אשר הוספו ידנית למנה
QTY / UNIT==כמות/יחידה
TOTAL QTY==סה"כ כמות
QTY BATCHED==כמות למנה
CE_HSRV NOT RESPONDING - CHECK APPLICATION SERVER IN HEAD OFFICE==תוכנית תקשורת במרכז לא פעילה! נא להודיע למשרד
INVALID CUSTOMER NR.==מספר לקוח שגוי
SELECTED ORDER IS NOT IN AN ACTIVE STATUS==ההזמנה לא פעילה! בדוק סטאטוס ההזמנה
SDQ_DEVIATION==סטייה
NOT_PRODUCTION_QNT==פריטים לא מיוצרים
REFRESH STOCK FOR SELECTED BRANCHS ?!==!? לרענן מלאי עבור מפעלים נבחרים
MISSING RECORDS==רשומות חסרות
DATE / TIME TO DO==שעה ותאריך לביצוע
CLICK TO CHANGE THE TRUCK'S STATUS==לחץ לשינוי סטאטוס משאיות
CONCRETE WAS OUT FOR TOO LONG==לא ניתן להחזיר בטון לאחר 90 דקות
NO QUANTITIES==אין כמות ליצור
SAMPLE INFORMATION==פרטי דגימה ע"י מעבדה חיצונית
SAMPLE TAKEN BY==נלקח על ידי
SAMPLING AUTHORITY==מעבדה
(EMPLTY)==ריק
SAMPLE TAKEN AT==שעת ביצוע
INVALID DATA FOR INTEGER VALUE....!!==!!...הנתון בשדה אינו מספרי
ITEMDESCRIPTION==תיאור פריט
START DESIGN FOR TABLE:==:תחילת עיצוב טבלה
NO PREVIOUS DELIVERY IN LAST 24 HOURS==אין אספקה קודמת ב-24 שעות אחרונות
THE CONCRETE ON BOARD CAN'T BE REUSED==הבטון הנבחר לא יכול להיות מוחזר
INCORRECT LINE ID==קוד שורה לא נכון
TRUCK SELECTION==בחירת משאית
ORDER PLANT==מפעל
ORDER CUSTOMER==לקוח
ORDER JOB==אתר
ORDER ITEM==פריט
ORDERED QTY==כמות שהוזמנה
REMAINING QTY==נשאר לאספקה
SELECT ORDER==בחירת הזמנה
CHECK IN==כניסה
CHECK OUT==יציאה
TARE STATUS==סטאטוס טרה
LAST TARE==טרה אחרונה
LAST TARE DATE/TIME==תאריך טרה אחרונה
READ TARE==שקילת טרה
REQUEST TARE==בקשת טרה
LOAD INFO.==פרטי תעודה
CHECK IN DATE/TIME==תאריך/שעת כניסה
LOAD REQ. CUSTOMER==לקוח
LOAD REQ. JOB==אתר
PREV. TICKET INFO.==פרטי תעודה קודמת
LAST TICKET CUSTOMER==לקוח תעודה האחרונה
LAST TICKET JOB==אתר תעודה האחרונה
LAST TICKET DATE/TIME==תאריך תעודה האחרונה
LOAD STACK==תעודות בהמתנה
LOAD DETAILS==פרטי תעודה
TARE==טרה
BRUTO==ברוטו
NET==נטו
CLICK TO READ TARE==לחץ לשקילת טרה
PRICING INFO.==פרטי תמחור
PRODUCT PRICE==מחיר הפריט
CALCULATED COST==עלות מחושבת
BRUTO TARE==ברוטו טרה
DEFAULT SCALE==משקל ברירת מחדל
SCALES==משקלים
CLEAR SELECTED LOAD==מחיקת התעודה הנבחרת
LAST TARE DATE AND TIME==תאריך טרה אחרונה
TARE REQUEST PENDING==*
TARE REQUEST PENDING - MUST WEIGH TARE==*
IS SCALE READY FOR READING==המשקל מוכן לקריאה
WRONG SCALE INFO.==טעות בנתונים שקילה
HAULING PRICE==מחיר הובלה
WHEN TRANSPORTER IS DEFINED, ENTER THE HAULING PRICE PER UOM.==הקלד מחיר הובלה ליחידה כאשר מוגדר מוביל לתעודה
NOT_P_QNT==הוזמנו לא מיוצרים
NOT_PROD_QNT==סופקו לא מיוצרים
SOLER_QNT==אספקת סולר
TMU_PLANT==מפעל
TMU_DATETIME==תאריך
TMU_CUST_CODE==לקוח
TMU_USER==משתמש
TMU_CONF_USER==מאשר
EXP_MACHON==מעבדה
EXP_DOGEM==דוגם
EXP_TIME==שעת מדגם
EXP_REMARK==הערת המדגם
SHD_NO_PRICE==תעודות ללא מחיר
NO MESSAGES==אין הודעות
WAIT FOR USER INPUT==ממתין להגדרת פרמטרים לחישוב
PROCESSING...==מבצע חישוב
PROCESS ENDED.==החישוב הסתיים -
RECORDS PROCESSED==תעודות חושבו!
LAST REC. NR.==מס' רשומת תחילה
REC. NR. AFTER GAP==מס' רשומה אחרי חלל ריק
CUST INT. CODE==*
THIS CODE IS USED BY THE CUSTOMER TO IDETIFY THE JOB SITE IN THEIR RECORDS==*
BUILD BATCH QTY==בניית כמויות יצור
TABLE NOT FOUND :==:לא קיימת טבלה
BATCH QUANTITIES ALLREADY EXIST==!קיימות כמויות יצור לתעודה זאת
NOT SELECTED==לא נבחר
SITE CAN NOT BE DELETED==לא ניתן למחוק אתר זה
CONFIRM TO QUIT==ברצונך לצאת מהתוכנה
DELETE THE LOGICAL SILO ?==?לחמוק סולו לוגי
DELETE THE BATCH UNIT AND ALL SUB TREE ITEMS ?==?למחוק עמדת יצור
CHANGE ROLE==בחר תפריט משתמש
NO SILOS DEFINED FOR THIS BATHC UNIT==לא הוגדרו סילואים לעמדת יצור זאת!
STOCK TRANSPHERE==*
ARE YOU SURE YOU WANT TO RESET THE CONTROLLER?==שים לב, הפעולה תבצע איפוס כמויות בבקר! האם אתה בטוח בביצע הפעולה?
GROUP ID==קוד קבוצה
GROUP DESC.==תיאור קבוצה
RIGHT ID==קוד הרשאה
RIGHT DESC.==תיאור הרשאה
USER ROLES==תפקידי משתמשים
MENU/ROLE DESC.==תיאור תפריט
MENU/ROLES FOR==תפריטי משתמשים
USER ROLES DB NOT INSTALLED==לא קיים בסיס לתפקידי משתמשים
DEFAULT MENU/ROLE==תפריט ברירת מחדל
NR==מספר
TRN_PLANT==מפעל במכון
NO RIGHT TO UPDATE OR DELETE BATCH BOOK NO==אין הרשאה לעדכון או מחיקת ספר אב
RECEIPT CAN NOT BE VOIDED==לא ניתן לבטל קבלה זאת
WRONG BRANCH !==סניף/מפעל שגוי
CONFIRM RECEIPT VOID==אישור ביטול קבלה
ARE YOU SURE YOU WANT TO VOID THIS RECEIPT?==?ברצונך לבטל קבלה זאת
THE QTY ON BOARD CAN'T BE MORE THEN THE QTY ON THE ORIGINAL TICKET==כמות בטון חוזר לא יכולה להיות גדולה מכמות בתעודה המקורית
THIS CONTRACT IS A BASE CONTRACT==ההסכם הינו הסכם בסיס
JOB SITES==*
INITILIZE==*
FRM_PROGRESS==התקדמות
ELAPSED (SEC)==חלף (שניות)
REMAINING (SEC)==נשאר (שניות)
CALC. PRICE FOR TICKETS==חישוב מחירים לתעודות
PLANT ID==מפעל
PLANT DESCRIPTION==תיאור
REFRESH ACTIVITY==החישוב פעיל
INVENTORY RECALC FINISHED==חישוב מלאי מחדש הסתיים
ACCOUNT CAN NOT BE DELETED DUE TO STATUS/DATA IN THE SYSTEM==אין הרשאה למחיקת החשבון
THIS TICKET WAS NOT PRODUCED==התעודה הוקמה כתעודה פיקטיבית ללא כמויות יצור
CONFIRM TO QUIT?==ברצונך לצאת מהתוכנה ?
SAVE NEW SAMPLE ?!==לשמור מדגם חדש ?
CREATED SUCCESSFULLY SAMPLE NO==הוקם בהצלחה מדגם מס'
TIMMING ERROR: THE SAME TRUCK HAD A TRIP BEFORE THE RETURN TO PLANT TIME==שים לב! השעות לא נכונות. יש תעודה סגורה לפני התעודה הנוכחית
COULD NOT DETERMINE TRIP TIME==לא נקבעה תדירות
SCAN==סריקה
DISPLAY SCHEDULED LOADS==הצגת תכנון העמסות
MODIFICATIONS WERE DONE TO THE DATA==השינויים נשמרו בנתונים
SELECT STATUS==בחר סטאטוס
NO OPTIONS AVAILABLE==אין אפשרויות זמינות
CHNG STAT==שינוי סטאטוס
DO CREDIT==ביצוע זיכוי
PERIOD DESCRIPTION==תיאור
PROD QTY (MIN)==כמות ליצור (מינ)
PROD QTY (MAX)==כמות ליצור (מקס)
--->==*
APPLY QTY==כמות הפעלות
FROM QTY==כמות ליצור (מינ)
TO QTY==כמות ליצור (מקס)
BUILD GENERAL LEDGER TRANS. FOR INVOICES==בניית שורות לחשבוניות
BUILD GENERAL LEDGER TRANS. FOR RECIEPTS==בניית שורות לקבלות
BUILD GENERAL LEDGER TRANS. FOR DEPOSITS==בניית שורות להפקדות
CE-INVOICE-VAT==מע"מ
CE-INVOICE-DISCOUNT==הנחות/עיגולים
TRANZACTION IS ALLREADY LINKED==הפקודת יומן כבר מקושרת
NOT_A NUMERIC VALUE==הערך בשדה אסמכתא לא מספרי. נא להקליד 0 אם אסמכתא לא קיימת
PLEAS ENTER QUANTITY==נא להקליד כמות
ARE YOU SURE ? BY CONFIMING THIS MESSAGE ALL DATA WILL BE LOST.==שים לב! לאחר אישור ההודעה הכמויות שחושבו ימחקו. תדרש לבצע את התהליך מחדש
TRUCK/DRIVER==משאית/נהג
BATCH BOOK # MUST BE DEFINED==חובה לבחור ספר אב
YOU CAN NOT BATCH EXCESSIVE MATERIALS==לא ניתן להמשיך בהעמסה! הכמויות לא מתאימות
INVALID SHIP DOCK NR==מספר תעודה שגוי
PLEASE FILL ALL NECCESSARY FIELDS==*
LINK DOCUMENT==קישור מסמך
DOCUMENT #==מספר
DEPOSIT IS ALLREADY LINKED !==ההפקדה כבר קשורה!
INVOICE DOES NOT EXIST==החשבונית לא קיימת!
RECEIPT IS ALLREADY LINKED !==הקבלה כבר קשורה!
RECEIPT DOES NOT EXIST==הקבלה לא קיימת!
DEPOSIT DOES NOT EXIST==ההפקדה לא קיימת!
___________==ממתין לביצוע
PROCESSING==מבצע חישוב
CALC. IN BOUND TICKETS==חישוב תעודות לפי הטווח המבוקש
FINISHED==החישוב הסתיים
GPS==*
ERROR WHEN OPENING OLE WITH MSEXCEL==שגיאה בהעברת נתונים לקובץ EXCEL
INVRECALC==חישוב מחדש
FOREIGN CUSTOMERS==לקוחות חיצוניים
CUSTOEMR WILL EXCEED MAX. CREDIT, CREATED ORDER ?==הלקוח עומד לעבור את גובה האשראי המאושר. להמשיך בהקמת הזמנה ?
DELETE PARAM==*
COPY FROM==*
COPY TO==*
MENU ALLREADY EXIST==התפריט כבר קיים
UPDATE COMPLAINT==עדכון תלונת לקוח
NEW COMPLAINT==תלונת לקוח חדשה
QTY (LEVEL1)==*
QTY (LEVEL2)==*
TRAILER_VALUE==ערך
QUOTE:==הצעה:
INVALID VALUE!==ערך לא נכון!
CUSTOMER:==לקוח:
PROJECT:==פרויירט:
REFERENCE TICKET==*
CE_QCS==מערכת אבטחת איכות
CE QCS - MAIN MENU==מערכת אבטחת איכות
SELECT DOCUMENT==בחר מסמך
CREATED SUCCESSFULLY COMPLAINT #==תלונת לקוח הוקמה בהצלחה. מספר
CONTACT PERSON IS MISSING OR MISTAKEN!==איש קשר חסר או שגוי
: FIELD DOES NOT EXIST==השדה לא נמצא
NO TRAILER DEFINITION FOUND==לא נמצאה הגדרת הנגרר
INCORRECT RETURN TIME==זמן חזרה שגוי
CONTRACT NUMBER==מספר הסכם
SITE:==אתר
RANGE IS MISSING==חסר טווח בחירה
MIRROR SITES==אתרים לחיקוי
INVALID SITE NUMBER==מספר אתר אינו נכון
CAPTIONS MAY NOT BE MODIFIED==*
INVOICED CUSTOMERS RANGE==לקוחות (לפי תשלום)
SUPPLIED CUSTOMERS RANGE==לקוחות (לפי הספקה)
NEXT TARE:==תאריך שקילה הבאה
WAIT FOR USER INPUT==ממתין לביצוע
PROCESSING...==מבצע חישוב...
PROCESS ENDED.==החישוב הסתיים -
RECORDS PROCESSED==תעודות חושבו
TARE EXPIRED==משקל טרה לא בתוקף
PLATE NUMBER -> TRUCK:==מס' רישוי - משאית
TRAILER:==נגרר
GROUP ID==קוד קבוצה
GROUP DESC.==תיאור קבוצה
RIGHT ID==קוד הרשאה
RIGHT DESC.==תיאור הרשאה
USER ROLES==תפקידי משתמשים
MENU/ROLE DESC.==תיאור תפריט
MENU/ROLES FOR==תפריטי משתמשים
USER ROLES DB NOT INSTALLED==לא קיים בסיס לתפקידי משתמשים
DEFAULT MENU/ROLE==תפריט ברירת מחדל
CHANGE ROLE==בחר תפריט משתמש
NR==מספר
SITE CAN NOT BE DELETED==לא ניתן למחוק האתר. קיימות תעודות משלוח
SEARCH:==חיפוש:
Invoice Branch :==סניף חשבונית
Invoice No :==מס' חשבונית
Extra Factor =>==יחס תוספת <=
Open Ship docks==ת.מ. לפני חשבונית
SHIPPING DOCKET VIEW OPENED==הצג ת. משלוח לפני חשבונית
OPENED SHIP DOCK REPORT==דו''ח ביקורת לפני חשבונית
WAITING==ממתינות
NEWS==חדשות
ACTIVES==פעילות היום
DAILY ORDERS==הזמנות היום
in sending==בשליחה
incoming==נכנסים
outgoing==יוצאים
Outgoing messages==הודעות יוצאות
Incoming messages==הודעות נכנסות
Reply==השב
Go to Order==פתח הזמנה
Sender==מאת
Send==שלח
SILO DETAILED INFO==מצב סילו מפורט
PLANT DESCRIPTION :==תיאור מפעל :
UNIT DESCRIPTION :==תיאור בקר :
SILO DESCRIPTION :==תיאור סילו :
MATERIAL DESCRIPTION :==תיאור חומר :
PHYS SILO DESCRIPTION :==תיאור סילו פיזי :
MAX SILO WEIGHT (T):==משקל סילו מקסימלי (T) :
CURRENT SILO WEIGHT (T) :==משקל סילו נוכחי (T) :
MATERIALCODE==קוד חומר
MATERIALDESC==תיאור חומר
CURRENTSILOWEIGHT==משקל סילו נוכחי (T)
MAXSILOWEIGHT==משקל סילו מקסימלי (T)
SILOPERCENT==שימוש סילו (%)
MEASURED AT :==נמדד ב :
B_P_ALARM_EMAILS==לשלוח התראות סילו ל:
TEUDA==תעודת משלוח
USEDQNT==שימוש (T)
TOTAL USAGE (T) :==שימוש (T) :
WEIGHT VARIATION (T) :==שינוי משקל (T) :
B_P_ALARM_USAGE_EMAILS==לשלוח דוח שימוש ל:
B_P_ALARM_USAGE_FROM_TIME==שעת עדכון:
B_P_ALARM_USAGE_TO_TIME==שימוש עד:
B_P_ALARM_DOWN_EMAILS==לשלוח התראת מכלית ל:
B_P_ALARM_DOWN_TONS==הסילו חסר (T):
Request washing==דורש שטיפה
You carried material==העמיסו חומר
CHECK_CONTRACT_EXPIRED==הסכם לא בתוקף!
Confirm the mixer was washed==אשר שהמשאית עברה שטיפה
Please confirm Password !==נא לאשר סיסמה !
Password must have at least 4 characters !==סיסמה חייב להכיל 4 אותיות או מספרים !
Old Password==סיסמה קיימת
Confim Password==אשר סיסמה
Password updated !==עדכון סיסמה הצליח !
Cannot update Password !==עדכון סיסמה נכשל !
Password inserted !==הוספת סיסמה הצליחה !
Cannot insert Password !==הוספת סיסמה נכשלה !
Please enter Password==נא להכניס סיסמה
יציאה==*
חדש==*
הוספה==*
מחיקה==*
הדפסה==*
תיאור==*
שם==*
שם ומיקום הקובץ==*
קבוצה==*
LIAD SYSTEMS==*
אישור==*
ביטול==*
חדשה==*
פעולות==*
הזמנות==*
תעודה==*
טיפול בתעודה==*
סידור אזורי==*
הודעות==*
עדכון==*
תכנון==*
משאיות==*
APP ORDERS==*
הזמנות היום==*
STOCK IMPORT==קליטת תעודות ספק
PN_TRUCKS==*
PN_ACTIVE_ORDERS==*
הזמנות פעילות==*
בחר משאית==*
PANEL5==*
OUTBOX==*
INBOX==*
הזמנות של מחר==*
PN_SHD==*
תעודות משלוח==*
סגור==*
ניהול==*
ללא משאית==*
חיבור==*
חזרה==*
PN_PRODUCTION==*
רשימת תעודות בהמתנה==*
תעודות לשליחה ידנית==*
מסופים==*
STOCKREJECTSAPAK_240604134521.XML==*
STOCKREJECTSAPAK_240604140924.XML==*
TBL710.XML==*
IMPORT==קלט
REJECT==דחה
SPD_FLD1_LABEL==*
SPD_FLD2_LABEL==*
PNL_RCV_INFO==*
בחירת חומרי גלם==*
כמות==*
CONVERTED_QTY==*
אבטחת איכות==*
ספק==*
פרטי ספק==*
תאריך ושעת תעודה==*
PNL_PLANT_DATE==*
מפעל מקבל==*
תאריך הכנסה==*
פרטי מוביל==*
TRANSPORT INCLUDED==*
There is no Contact Person To Choose!==לא נמצא איש קשר לבחירה!
Nothing To Delete==אין פריטים למחיקה!
Contact Person is Missing!==חובה להזין פרטי איש קשר!
QUANTITY IS MISSING==חובה להזין כמות!
Site 0 not allowed==חובה לבחור אתר עבודה!
ELEMENT MUST BE DEFINED==חובה לבחור אלמנט!
Exposure Level Must be Defined==חובה להגדיר רמת חשיפה!
Pricing is Not Defined for The Item==חובה להגדיר מחיר עבור הפריט!
Custome Not Found==חובה להגדיר לקוח!
Print Last==הדפס אחרון
OPERATIONS==פעולות סדרן
TRUCKS==תכנון משאיות
DEF_ORDER_STATUS==סטאטוס הזמנה
COR_STATUS==סטאטוס
ALLOW SUPPLY WITHOUT PRICING==אספקה של פריטים ללא מגבלה (ניתן לספק מוצרים ללא הסכם)
CUSTOMER==לקוח
CUSTOMER *==* לקוח
JOB SITE *==* אתר העבודה
ORDER USAGE *==* אלמנט
Exposure Lvl *==* רמת חשיפה
ORDERED *==* הוזמן
SCHEDULED *==* תוכנן
ITEM *==* פריט
PLEASE ENTER YOUR NAME AND PASSWORD...==נא למלא שם וסיסמה בכניסה למערכת
NAME==* שם
PASSWORD==* סיסמה
PRINT SELECTED TKTS==הדפס תעודות שנבחרו
COR_QNT_SUPP_TODAY==סופק מתחילת היום
CURR.QTY==כמות אספקה הבאה
NEXT SUPP.==זמן אספקה הבאה
COR_QNT==לאספקה
COR_QNT_SUPP==סופק
COR_QNT_TO_SUPPLY==נשאר לאספקה
CorQntToSuppToday==הזמנות להיום
COR_QNT_SUPP_TODAY==סופק היום
NO TRK==בטל סימון משאית
remove_pending_load==בטל תעודה
set_load_to_pending==העבר להמתנה
set_load_to_terminal==העבר למסוף
Transport Included==כולל הובלה
Line Remark==הערה
SPD_FLD1_LABEL==פחמן % (חובה לאפר פחם)
SPD_FLD2_LABEL==משקל סגולי (לכימיקלים)
Notes must be less than 120 letters.==ניתן לרשום הערות עד 120 טווים בלבד.
ORDERS==הזמנות קודמות
CHOOSE TRK==משאית אחרונה
ORDER TIMING NOTES==תיעוד שיחות 
TIMING NOTE ID==מספר פניה
CLIENT REQUEST DATE==תאריך פניה
COR_CLIENT_REQ_DATE==תאריך לאספקה
COR_CLIENT_NAME==שם המבקש
COR_CLIENT_PHONE==טלפון המבקש
COR_NOTES==הערות
Clean Fields==נקה שדות
Refresh Data==רענן מידע
Sunday==ראשון
Enable Event==אירוע פעיל
Event Properties==הגדרת אירוע	
Report Number==מספר דוח
Run at Hour==שעת הפעלה
Success:==בוצע בהצלחה:
Statement executed.==הפקודה בוצעה.
Internal Remark==הערה פנימית
Client Remark==הערה ללקוח
Print PDF==*הדפסה PDF
Export to Excel==*יצוא ל-EXCEL
Multi Leave==הורד כמות
Leave All==הורד הכל
Multi Entry==הכנס כמות
Transporter is Missing!==יש לבחור מוביל!
You must select a dispatch from the waiting list only.==עליך לבחור תעודת משלוח מרשימת ההמתנה בלבד.
Are you sure you want to delete this dispatch from the waiting list?==האם למחוק את תעודת המשלוח מרשימת ההמתנה?
You do not have a TOTP, would you like to create?==אין לך קוד אימות דו שלבי (TOTP). האם ברצונך ליצור אחד כעת?